ID,Флаг дозвона,Флаг продажи,Расходы,PV,NPV
0,1,1,230,1406,1176
1,1,0,69,0,-69
2,0,0,8,0,-8
3,1,0,18,0,-18
4,1,0,14,0,-14
5,0,0,22,0,-22
6,1,0,0,0,0
7,1,1,503,1738,1235
8,1,1,411,1236,825
9,0,0,24,0,-24
10,0,0,143,0,-143
11,1,1,347,1480,1133
12,1,1,399,1715,1316
13,0,0,3,0,-3
14,1,1,189,1456,1267
15,0,0,29,0,-29
16,1,1,276,3715,3439
17,1,1,85,1421,1336
18,1,0,12,0,-12
19,1,0,14,0,-14
20,1,1,1384,1356,-28
21,1,1,137,1235,1098
22,0,0,78,0,-78
23,1,1,554,1647,1093
24,0,0,132,0,-132
25,1,0,34,0,-34
26,0,0,5,0,-5
27,1,1,1730,1528,-202
28,1,1,308,1211,903
29,0,0,28,0,-28
30,0,0,58,0,-58
31,0,0,59,0,-59
32,1,0,7,0,-7
33,1,0,18,0,-18
34,0,0,33,0,-33
35,0,0,18,0,-18
36,1,0,89,0,-89
37,1,0,26,0,-26
38,1,1,928,1329,401
39,0,0,69,0,-69
40,1,0,0,0,0
41,0,0,8,0,-8
42,1,0,184,0,-184
43,1,0,24,0,-24
44,0,0,72,0,-72
45,1,1,410,1240,830
46,1,0,5,0,-5
47,1,1,87,1223,1136
48,1,1,349,1298,949
49,0,0,103,0,-103
50,1,0,23,0,-23
51,0,0,68,0,-68
52,1,1,545,1202,657
53,1,1,50,1964,1914
54,1,1,569,1202,633
55,1,1,251,1227,976
56,0,0,15,0,-15
57,0,0,52,0,-52
58,1,1,367,1521,1154
59,1,1,1550,1387,-163
60,1,1,88,1221,1133
61,0,0,33,0,-33
62,1,1,269,1223,954
63,1,1,70,1217,1147
64,1,1,1500,1254,-246
65,0,0,20,0,-20
66,1,1,422,2171,1749
67,1,0,167,0,-167
68,1,0,59,0,-59
69,0,0,73,0,-73
70,1,1,503,1437,934
71,0,0,73,0,-73
72,1,0,37,0,-37
73,0,0,18,0,-18
74,1,1,389,2798,2409
75,1,1,58,1397,1339
76,0,0,36,0,-36
77,0,0,5,0,-5
78,0,0,81,0,-81
79,1,1,389,2335,1946
80,1,1,345,1435,1090
81,1,0,11,0,-11
82,1,0,17,0,-17
83,0,0,52,0,-52
84,1,1,1045,1766,721
85,0,0,1,0,-1
86,0,0,40,0,-40
87,0,0,54,0,-54
88,1,0,110,0,-110
89,1,1,1172,1679,507
90,1,1,127,1770,1643
91,0,0,21,0,-21
92,1,1,152,1354,1202
93,0,0,24,0,-24
94,1,0,40,0,-40
95,1,1,568,1330,762
96,0,0,107,0,-107
97,1,0,20,0,-20
98,1,0,71,0,-71
99,1,1,710,1228,518
100,0,0,34,0,-34
101,0,0,60,0,-60
102,0,0,4,0,-4
103,0,0,27,0,-27
104,1,0,38,0,-38
105,1,0,19,0,-19
106,0,0,29,0,-29
107,1,1,665,1480,815
108,1,0,5,0,-5
109,1,0,72,0,-72
110,1,0,132,0,-132
111,0,0,2,0,-2
112,0,0,260,0,-260
113,1,0,27,0,-27
114,0,0,87,0,-87
115,0,0,100,0,-100
116,1,0,25,0,-25
117,0,0,31,0,-31
118,0,0,33,0,-33
119,1,1,460,1497,1037
120,1,0,28,0,-28
121,1,1,1331,2061,730
122,1,0,20,0,-20
123,0,0,60,0,-60
124,0,0,12,0,-12
125,1,1,114,1285,1171
126,1,0,61,0,-61
127,0,0,37,0,-37
128,1,1,664,1274,610
129,1,0,2,0,-2
130,0,0,41,0,-41
131,0,0,60,0,-60
132,0,0,12,0,-12
133,1,0,71,0,-71
134,1,0,31,0,-31
135,1,0,9,0,-9
136,1,1,1040,1715,675
137,1,1,941,1232,291
138,1,0,173,0,-173
139,1,1,113,1396,1283
140,1,1,205,1565,1360
141,1,0,1,0,-1
142,1,1,482,1293,811
143,1,0,75,0,-75
144,1,0,26,0,-26
145,0,0,20,0,-20
146,0,0,176,0,-176
147,0,0,35,0,-35
148,1,0,5,0,-5
149,1,1,66,1303,1237
150,1,1,106,1477,1371
151,1,1,38,1430,1392
152,0,0,137,0,-137
153,1,1,365,1211,846
154,1,1,223,1259,1036
155,1,0,24,0,-24
156,0,0,30,0,-30
157,0,0,44,0,-44
158,0,0,35,0,-35
159,0,0,12,0,-12
160,0,0,10,0,-10
161,1,0,8,0,-8
162,1,1,1548,2002,454
163,1,1,161,1207,1046
164,0,0,40,0,-40
165,0,0,78,0,-78
166,1,1,360,1238,878
167,0,0,19,0,-19
168,1,0,6,0,-6
169,0,0,28,0,-28
170,0,0,55,0,-55
171,0,0,2,0,-2
172,1,1,669,1474,805
173,0,0,38,0,-38
174,0,0,0,0,0
175,1,1,1224,1281,57
176,1,1,453,1271,818
177,1,1,181,1531,1350
178,0,0,18,0,-18
179,0,0,27,0,-27
180,1,1,664,1389,725
181,1,0,253,0,-253
182,0,0,3,0,-3
183,0,0,50,0,-50
184,0,0,74,0,-74
185,1,1,424,1253,829
186,1,1,656,1505,849
187,0,0,35,0,-35
188,1,0,194,0,-194
189,1,0,20,0,-20
190,1,0,22,0,-22
191,1,1,298,2060,1762
192,1,1,1139,1248,109
193,1,1,320,1543,1223
194,0,0,11,0,-11
195,0,0,26,0,-26
196,0,0,39,0,-39
197,1,0,12,0,-12
198,0,0,26,0,-26
199,1,1,118,3640,3522
200,1,1,1949,1260,-689
201,0,0,6,0,-6
202,0,0,18,0,-18
203,1,0,68,0,-68
204,1,0,36,0,-36
205,1,1,196,1619,1423
206,0,0,56,0,-56
207,0,0,39,0,-39
208,1,0,13,0,-13
209,0,0,4,0,-4
210,1,0,93,0,-93
211,0,0,25,0,-25
212,1,1,541,1584,1043
213,0,0,118,0,-118
214,1,1,1141,1307,166
215,0,0,90,0,-90
216,0,0,24,0,-24
217,0,0,182,0,-182
218,1,0,46,0,-46
219,1,1,81,1401,1320
220,0,0,2,0,-2
221,1,0,3,0,-3
222,1,0,86,0,-86
223,1,1,309,1320,1011
224,0,0,115,0,-115
225,1,1,223,1403,1180
226,1,0,16,0,-16
227,0,0,7,0,-7
228,0,0,24,0,-24
229,0,0,14,0,-14
230,0,0,122,0,-122
231,0,0,20,0,-20
232,0,0,41,0,-41
233,1,1,383,1664,1281
234,1,1,422,1281,859
235,1,0,33,0,-33
236,1,0,8,0,-8
237,1,1,482,1512,1030
238,1,1,228,1570,1342
239,1,0,0,0,0
240,1,1,235,6425,6190
241,1,1,748,1362,614
242,1,0,95,0,-95
243,1,1,44,1902,1858
244,0,0,35,0,-35
245,1,1,364,1224,860
246,1,1,305,1512,1207
247,1,0,3,0,-3
248,1,1,819,1310,491
249,1,0,14,0,-14
250,0,0,37,0,-37
251,0,0,1,0,-1
252,1,1,1502,1497,-5
253,1,0,25,0,-25
254,1,0,33,0,-33
255,1,0,15,0,-15
256,1,1,525,1543,1018
257,1,1,203,1208,1005
258,1,0,71,0,-71
259,0,0,86,0,-86
260,1,0,25,0,-25
261,1,0,59,0,-59
262,0,0,21,0,-21
263,1,1,105,1895,1790
264,0,0,117,0,-117
265,1,0,24,0,-24
266,1,1,189,1374,1185
267,0,0,111,0,-111
268,1,0,41,0,-41
269,1,1,304,1209,905
270,1,0,78,0,-78
271,1,1,299,2062,1763
272,1,0,106,0,-106
273,1,0,37,0,-37
274,0,0,125,0,-125
275,1,1,47,1247,1200
276,0,0,71,0,-71
277,1,0,1,0,-1
278,1,0,11,0,-11
279,1,1,1916,1321,-595
280,1,0,2,0,-2
281,0,0,52,0,-52
282,0,0,3,0,-3
283,1,1,59,1388,1329
284,1,1,235,1218,983
285,1,1,1180,1274,94
286,1,1,138,1361,1223
287,1,0,52,0,-52
288,0,0,56,0,-56
289,0,0,51,0,-51
290,0,0,25,0,-25
291,0,0,167,0,-167
292,0,0,38,0,-38
293,0,0,85,0,-85
294,1,0,4,0,-4
295,0,0,38,0,-38
296,0,0,39,0,-39
297,0,0,35,0,-35
298,1,0,15,0,-15
299,1,1,112,1270,1158
300,1,0,42,0,-42
301,0,0,25,0,-25
302,1,0,7,0,-7
303,0,0,10,0,-10
304,1,1,857,1281,424
305,0,0,5,0,-5
306,0,0,78,0,-78
307,1,0,36,0,-36
308,0,0,95,0,-95
309,1,1,156,1551,1395
310,1,1,733,1257,524
311,0,0,25,0,-25
312,0,0,31,0,-31
313,1,0,92,0,-92
314,1,1,7,1205,1198
315,1,0,6,0,-6
316,1,0,141,0,-141
317,1,1,585,1555,970
318,0,0,1,0,-1
319,0,0,11,0,-11
320,1,1,2235,1567,-668
321,0,0,0,0,0
322,0,0,75,0,-75
323,1,0,17,0,-17
324,1,1,143,2017,1874
325,1,1,91,1334,1243
326,1,1,347,1319,972
327,1,1,593,1373,780
328,0,0,7,0,-7
329,1,0,133,0,-133
330,1,1,134,1350,1216
331,0,0,16,0,-16
332,1,1,185,2097,1912
333,1,1,477,1511,1034
334,1,1,245,1390,1145
335,0,0,32,0,-32
336,1,1,2912,1322,-1590
337,1,0,58,0,-58
338,0,0,48,0,-48
339,1,1,134,1339,1205
340,1,1,60,2650,2590
341,0,0,70,0,-70
342,0,0,86,0,-86
343,1,1,256,1294,1038
344,1,0,26,0,-26
345,1,1,105,1391,1286
346,1,0,1,0,-1
347,1,0,45,0,-45
348,1,1,94,1273,1179
349,1,0,109,0,-109
350,0,0,26,0,-26
351,0,0,18,0,-18
352,1,1,189,1289,1100
353,1,1,627,1413,786
354,1,0,98,0,-98
355,1,0,17,0,-17
356,1,1,419,1214,795
357,0,0,14,0,-14
358,0,0,22,0,-22
359,1,1,952,1782,830
360,1,0,20,0,-20
361,0,0,9,0,-9
362,1,0,10,0,-10
363,0,0,14,0,-14
364,0,0,6,0,-6
365,0,0,42,0,-42
366,1,1,365,1271,906
367,0,0,71,0,-71
368,1,1,214,1292,1078
369,1,0,77,0,-77
370,1,0,18,0,-18
371,0,0,12,0,-12
372,0,0,5,0,-5
373,1,0,36,0,-36
374,1,1,303,2444,2141
375,0,0,111,0,-111
376,0,0,134,0,-134
377,1,1,1939,1610,-329
378,0,0,20,0,-20
379,0,0,31,0,-31
380,1,0,22,0,-22
381,1,1,1445,1388,-57
382,0,0,156,0,-156
383,1,1,519,1233,714
384,1,0,8,0,-8
385,1,0,196,0,-196
386,0,0,2,0,-2
387,1,0,19,0,-19
388,0,0,52,0,-52
389,0,0,12,0,-12
390,1,0,12,0,-12
391,1,0,141,0,-141
392,1,0,43,0,-43
393,1,0,48,0,-48
394,1,0,45,0,-45
395,1,1,245,1317,1072
396,1,0,28,0,-28
397,1,0,14,0,-14
398,1,1,1469,1696,227
399,1,1,930,1676,746
400,0,0,51,0,-51
401,0,0,28,0,-28
402,1,0,70,0,-70
403,1,1,495,2032,1537
404,0,0,1,0,-1
405,1,1,1185,1461,276
406,0,0,1,0,-1
407,1,0,34,0,-34
408,0,0,11,0,-11
409,0,0,81,0,-81
410,0,0,3,0,-3
411,0,0,132,0,-132
412,1,0,41,0,-41
413,0,0,20,0,-20
414,0,0,38,0,-38
415,0,0,22,0,-22
416,1,0,0,0,0
417,1,0,75,0,-75
418,1,0,31,0,-31
419,1,1,107,1496,1389
420,1,1,238,2494,2256
421,0,0,160,0,-160
422,1,1,240,1488,1248
423,0,0,38,0,-38
424,1,1,95,1403,1308
425,1,0,39,0,-39
426,0,0,22,0,-22
427,1,1,465,1245,780
428,0,0,37,0,-37
429,0,0,58,0,-58
430,1,1,689,1267,578
431,1,0,18,0,-18
432,1,0,3,0,-3
433,0,0,55,0,-55
434,0,0,32,0,-32
435,1,1,160,1788,1628
436,1,1,836,1296,460
437,0,0,161,0,-161
438,1,1,30,1444,1414
439,0,0,69,0,-69
440,1,1,239,1283,1044
441,0,0,202,0,-202
442,1,1,158,1625,1467
443,1,1,552,2379,1827
444,0,0,149,0,-149
445,0,0,14,0,-14
446,0,0,18,0,-18
447,0,0,8,0,-8
448,0,0,36,0,-36
449,1,0,62,0,-62
450,0,0,63,0,-63
451,0,0,35,0,-35
452,0,0,24,0,-24
453,1,0,39,0,-39
454,1,1,821,1649,828
455,0,0,2,0,-2
456,1,1,199,1260,1061
457,1,1,345,1443,1098
458,1,1,580,1787,1207
459,1,1,102,1390,1288
460,0,0,37,0,-37
461,0,0,44,0,-44
462,1,0,6,0,-6
463,1,0,102,0,-102
464,1,1,305,2306,2001
465,1,1,248,1372,1124
466,0,0,13,0,-13
467,0,0,182,0,-182
468,1,1,1449,1507,58
469,1,1,639,1555,916
470,1,1,378,1572,1194
471,1,1,300,1418,1118
472,1,1,536,2300,1764
473,1,1,1331,1758,427
474,1,0,10,0,-10
475,0,0,25,0,-25
476,0,0,8,0,-8
477,0,0,3,0,-3
478,0,0,29,0,-29
479,1,1,155,1262,1107
480,1,0,59,0,-59
481,1,1,595,1421,826
482,0,0,31,0,-31
483,0,0,2,0,-2
484,0,0,141,0,-141
485,1,0,6,0,-6
486,1,1,53,1351,1298
487,0,0,25,0,-25
488,1,1,12,1356,1344
489,0,0,282,0,-282
490,0,0,122,0,-122
491,1,1,162,1753,1591
492,1,0,182,0,-182
493,1,1,391,1247,856
494,1,0,63,0,-63
495,0,0,1,0,-1
496,0,0,0,0,0
497,1,0,55,0,-55
498,0,0,14,0,-14
499,1,1,13,1204,1191
500,1,1,162,1516,1354
501,1,1,44,1249,1205
502,0,0,2,0,-2
503,0,0,29,0,-29
504,0,0,49,0,-49
505,0,0,171,0,-171
506,0,0,43,0,-43
507,0,0,43,0,-43
508,0,0,39,0,-39
509,1,1,261,1511,1250
510,0,0,82,0,-82
511,1,1,803,1350,547
512,1,0,31,0,-31
513,0,0,20,0,-20
514,1,1,1439,1224,-215
515,0,0,23,0,-23
516,1,1,118,1302,1184
517,0,0,6,0,-6
518,0,0,9,0,-9
519,0,0,51,0,-51
520,1,0,11,0,-11
521,0,0,99,0,-99
522,0,0,12,0,-12
523,1,0,22,0,-22
524,1,0,26,0,-26
525,1,1,244,1682,1438
526,0,0,28,0,-28
527,1,0,42,0,-42
528,0,0,54,0,-54
529,1,1,619,2991,2372
530,1,1,577,2125,1548
531,1,0,46,0,-46
532,1,0,36,0,-36
533,1,1,122,1256,1134
534,1,0,2,0,-2
535,1,0,15,0,-15
536,1,1,92,1222,1130
537,1,0,51,0,-51
538,1,0,112,0,-112
539,0,0,46,0,-46
540,1,0,44,0,-44
541,0,0,6,0,-6
542,0,0,2,0,-2
543,1,1,696,1262,566
544,0,0,102,0,-102
545,0,0,0,0,0
546,1,0,8,0,-8
547,0,0,76,0,-76
548,1,0,18,0,-18
549,1,1,786,2466,1680
550,1,1,935,1278,343
551,0,0,50,0,-50
552,1,0,1,0,-1
553,1,0,29,0,-29
554,0,0,27,0,-27
555,0,0,73,0,-73
556,0,0,10,0,-10
557,1,1,313,2967,2654
558,1,0,137,0,-137
559,1,1,92,1426,1334
560,1,1,99,1372,1273
561,1,0,77,0,-77
562,0,0,143,0,-143
563,1,1,245,1515,1270
564,1,1,324,1604,1280
565,0,0,11,0,-11
566,0,0,6,0,-6
567,0,0,11,0,-11
568,1,1,1246,2154,908
569,0,0,27,0,-27
570,1,0,0,0,0
571,1,0,74,0,-74
572,0,0,35,0,-35
573,1,1,814,1719,905
574,1,0,35,0,-35
575,0,0,39,0,-39
576,1,0,63,0,-63
577,0,0,26,0,-26
578,1,0,33,0,-33
579,1,0,69,0,-69
580,1,0,64,0,-64
581,0,0,34,0,-34
582,1,0,43,0,-43
583,1,1,643,1224,581
584,1,0,47,0,-47
585,0,0,19,0,-19
586,0,0,131,0,-131
587,1,1,769,1453,684
588,1,0,75,0,-75
589,0,0,37,0,-37
590,1,1,502,1480,978
591,1,1,545,1218,673
592,0,0,200,0,-200
593,1,1,147,2357,2210
594,0,0,53,0,-53
595,0,0,72,0,-72
596,1,0,12,0,-12
597,1,1,276,1278,1002
598,1,1,880,1961,1081
599,1,1,182,1539,1357
600,0,0,11,0,-11
601,1,0,37,0,-37
602,1,1,469,1349,880
603,0,0,3,0,-3
604,1,1,1135,1325,190
605,0,0,33,0,-33
606,1,0,15,0,-15
607,0,0,38,0,-38
608,1,1,887,1317,430
609,0,0,81,0,-81
610,1,1,233,1721,1488
611,1,0,8,0,-8
612,1,0,30,0,-30
613,0,0,26,0,-26
614,1,1,240,3140,2900
615,1,0,56,0,-56
616,0,0,16,0,-16
617,1,1,314,1384,1070
618,1,0,96,0,-96
619,0,0,17,0,-17
620,1,0,11,0,-11
621,1,1,432,1591,1159
622,0,0,68,0,-68
623,1,0,5,0,-5
624,1,1,1513,1473,-40
625,0,0,31,0,-31
626,1,1,841,1505,664
627,1,0,83,0,-83
628,1,1,282,1267,985
629,1,1,595,1452,857
630,0,0,32,0,-32
631,1,0,22,0,-22
632,1,0,86,0,-86
633,0,0,125,0,-125
634,0,0,13,0,-13
635,1,1,220,1326,1106
636,0,0,27,0,-27
637,1,0,213,0,-213
638,1,0,139,0,-139
639,1,0,92,0,-92
640,1,0,110,0,-110
641,0,0,239,0,-239
642,1,1,658,1878,1220
643,1,0,21,0,-21
644,0,0,45,0,-45
645,1,0,21,0,-21
646,0,0,113,0,-113
647,0,0,54,0,-54
648,1,0,6,0,-6
649,1,0,322,0,-322
650,1,0,51,0,-51
651,0,0,9,0,-9
652,0,0,19,0,-19
653,0,0,5,0,-5
654,1,1,48,1468,1420
655,1,1,874,1216,342
656,0,0,73,0,-73
657,1,1,256,1439,1183
658,1,1,847,1226,379
659,1,1,471,1239,768
660,1,1,831,1871,1040
661,1,0,48,0,-48
662,1,1,328,1761,1433
663,1,1,416,1249,833
664,0,0,3,0,-3
665,1,1,131,2490,2359
666,0,0,12,0,-12
667,1,1,177,1339,1162
668,1,0,33,0,-33
669,0,0,5,0,-5
670,1,1,415,1241,826
671,1,0,5,0,-5
672,1,1,342,1558,1216
673,1,1,210,1652,1442
674,0,0,121,0,-121
675,0,0,27,0,-27
676,0,0,51,0,-51
677,1,1,1474,1911,437
678,0,0,112,0,-112
679,1,0,92,0,-92
680,1,1,1163,1366,203
681,0,0,49,0,-49
682,0,0,33,0,-33
683,1,0,4,0,-4
684,0,0,39,0,-39
685,1,0,22,0,-22
686,1,1,375,1234,859
687,1,0,16,0,-16
688,0,0,7,0,-7
689,1,0,10,0,-10
690,0,0,15,0,-15
691,1,1,151,2091,1940
692,0,0,14,0,-14
693,0,0,18,0,-18
694,1,1,594,1338,744
695,0,0,80,0,-80
696,1,0,51,0,-51
697,1,0,79,0,-79
698,0,0,13,0,-13
699,0,0,48,0,-48
700,1,1,156,1357,1201
701,1,0,27,0,-27
702,0,0,8,0,-8
703,0,0,125,0,-125
704,0,0,9,0,-9
705,0,0,36,0,-36
706,1,1,256,1482,1226
707,0,0,6,0,-6
708,1,1,1265,1322,57
709,1,1,741,1641,900
710,1,1,631,1258,627
711,1,1,286,1246,960
712,0,0,40,0,-40
713,0,0,23,0,-23
714,1,0,11,0,-11
715,1,1,201,1381,1180
716,1,0,41,0,-41
717,0,0,14,0,-14
718,1,1,773,1285,512
719,0,0,190,0,-190
720,1,1,576,1222,646
721,1,1,1220,4176,2956
722,1,0,27,0,-27
723,0,0,1,0,-1
724,0,0,9,0,-9
725,0,0,0,0,0
726,0,0,41,0,-41
727,1,1,745,1677,932
728,1,0,76,0,-76
729,0,0,171,0,-171
730,1,0,7,0,-7
731,0,0,6,0,-6
732,1,0,52,0,-52
733,1,0,12,0,-12
734,0,0,130,0,-130
735,0,0,95,0,-95
736,1,0,14,0,-14
737,0,0,1,0,-1
738,0,0,29,0,-29
739,1,1,598,2953,2355
740,0,0,16,0,-16
741,0,0,49,0,-49
742,1,0,67,0,-67
743,0,0,9,0,-9
744,0,0,50,0,-50
745,1,0,64,0,-64
746,1,1,244,1216,972
747,1,1,816,1302,486
748,1,0,15,0,-15
749,0,0,3,0,-3
750,0,0,57,0,-57
751,1,0,22,0,-22
752,1,1,989,1222,233
753,1,1,272,1223,951
754,0,0,121,0,-121
755,0,0,53,0,-53
756,1,1,813,1596,783
757,1,0,91,0,-91
758,0,0,18,0,-18
759,1,0,59,0,-59
760,1,1,1851,1283,-568
761,0,0,35,0,-35
762,1,1,255,1425,1170
763,0,0,38,0,-38
764,0,0,6,0,-6
765,1,0,61,0,-61
766,1,1,646,1296,650
767,0,0,11,0,-11
768,1,1,335,1262,927
769,1,1,93,1899,1806
770,1,0,46,0,-46
771,0,0,34,0,-34
772,1,0,13,0,-13
773,1,1,279,1209,930
774,1,0,46,0,-46
775,1,1,109,1232,1123
776,1,0,65,0,-65
777,1,0,19,0,-19
778,0,0,40,0,-40
779,1,1,250,1452,1202
780,1,1,369,1317,948
781,1,0,0,0,0
782,0,0,42,0,-42
783,1,1,85,2082,1997
784,1,0,8,0,-8
785,0,0,68,0,-68
786,1,1,93,5794,5701
787,1,1,100,2076,1976
788,1,0,24,0,-24
789,1,0,34,0,-34
790,1,0,19,0,-19
791,0,0,118,0,-118
792,1,0,35,0,-35
793,1,0,135,0,-135
794,1,0,133,0,-133
795,1,0,28,0,-28
796,0,0,63,0,-63
797,1,1,237,1870,1633
798,1,1,284,1261,977
799,0,0,29,0,-29
800,1,1,355,1255,900
801,0,0,10,0,-10
802,1,1,242,1748,1506
803,1,0,4,0,-4
804,1,0,35,0,-35
805,0,0,5,0,-5
806,1,1,397,1910,1513
807,1,0,5,0,-5
808,1,1,736,1280,544
809,1,1,229,1361,1132
810,0,0,17,0,-17
811,1,0,31,0,-31
812,1,1,410,1376,966
813,1,0,23,0,-23
814,1,0,7,0,-7
815,1,0,14,0,-14
816,1,0,24,0,-24
817,1,1,239,1743,1504
818,0,0,89,0,-89
819,1,1,1032,1481,449
820,0,0,4,0,-4
821,0,0,43,0,-43
822,0,0,20,0,-20
823,1,1,419,1454,1035
824,1,1,233,1389,1156
825,0,0,41,0,-41
826,1,0,15,0,-15
827,1,1,164,1312,1148
828,1,0,1,0,-1
829,0,0,19,0,-19
830,1,1,1876,1588,-288
831,0,0,78,0,-78
832,0,0,21,0,-21
833,0,0,17,0,-17
834,0,0,111,0,-111
835,0,0,36,0,-36
836,1,0,60,0,-60
837,1,0,52,0,-52
838,1,0,2,0,-2
839,0,0,47,0,-47
840,1,0,24,0,-24
841,1,0,105,0,-105
842,0,0,76,0,-76
843,1,1,415,1292,877
844,0,0,25,0,-25
845,0,0,55,0,-55
846,1,1,677,1897,1220
847,0,0,38,0,-38
848,0,0,34,0,-34
849,0,0,11,0,-11
850,0,0,85,0,-85
851,1,0,0,0,0
852,1,0,24,0,-24
853,1,1,524,1395,871
854,0,0,97,0,-97
855,1,1,296,1224,928
856,1,1,364,1777,1413
857,0,0,11,0,-11
858,1,1,2388,1772,-616
859,0,0,4,0,-4
860,1,1,1417,1342,-75
861,1,1,481,1402,921
862,1,0,11,0,-11
863,0,0,101,0,-101
864,0,0,145,0,-145
865,1,1,973,1873,900
866,1,1,263,1204,941
867,0,0,12,0,-12
868,1,1,94,1875,1781
869,0,0,7,0,-7
870,1,1,212,1446,1234
871,0,0,8,0,-8
872,1,1,562,1359,797
873,1,1,470,1468,998
874,0,0,18,0,-18
875,1,1,240,1260,1020
876,0,0,206,0,-206
877,0,0,71,0,-71
878,1,0,32,0,-32
879,0,0,58,0,-58
880,0,0,25,0,-25
881,1,0,36,0,-36
882,1,1,560,1545,985
883,0,0,88,0,-88
884,1,0,135,0,-135
885,1,0,3,0,-3
886,0,0,9,0,-9
887,1,1,1130,1501,371
888,0,0,90,0,-90
889,1,0,36,0,-36
890,0,0,327,0,-327
891,0,0,19,0,-19
892,0,0,26,0,-26
893,1,1,138,1213,1075
894,0,0,13,0,-13
895,1,0,11,0,-11
896,0,0,72,0,-72
897,0,0,21,0,-21
898,0,0,57,0,-57
899,1,1,353,1323,970
900,0,0,64,0,-64
901,0,0,13,0,-13
902,0,0,32,0,-32
903,1,1,533,1311,778
904,0,0,14,0,-14
905,0,0,34,0,-34
906,1,1,127,1767,1640
907,0,0,18,0,-18
908,1,0,24,0,-24
909,1,1,900,1441,541
910,1,0,59,0,-59
911,0,0,35,0,-35
912,1,0,5,0,-5
913,0,0,68,0,-68
914,1,0,0,0,0
915,1,1,1132,1347,215
916,0,0,60,0,-60
917,0,0,36,0,-36
918,0,0,90,0,-90
919,0,0,144,0,-144
920,1,0,5,0,-5
921,1,1,136,1546,1410
922,1,1,345,1276,931
923,0,0,29,0,-29
924,0,0,15,0,-15
925,0,0,56,0,-56
926,1,0,13,0,-13
927,1,1,419,1560,1141
928,0,0,36,0,-36
929,0,0,16,0,-16
930,1,0,32,0,-32
931,0,0,21,0,-21
932,1,0,18,0,-18
933,1,1,996,1493,497
934,1,0,7,0,-7
935,1,1,73,1305,1232
936,0,0,114,0,-114
937,1,0,18,0,-18
938,0,0,25,0,-25
939,0,0,11,0,-11
940,0,0,12,0,-12
941,1,1,102,1400,1298
942,1,0,42,0,-42
943,1,0,126,0,-126
944,1,0,86,0,-86
945,1,0,15,0,-15
946,0,0,54,0,-54
947,1,0,0,0,0
948,0,0,197,0,-197
949,0,0,66,0,-66
950,1,0,16,0,-16
951,1,0,16,0,-16
952,1,1,312,1258,946
953,0,0,87,0,-87
954,0,0,21,0,-21
955,1,0,79,0,-79
956,1,1,72,1317,1245
957,1,1,405,1520,1115
958,1,0,35,0,-35
959,1,0,107,0,-107
960,1,0,52,0,-52
961,1,0,86,0,-86
962,1,1,375,1807,1432
963,1,1,399,1215,816
964,0,0,9,0,-9
965,1,0,23,0,-23
966,0,0,41,0,-41
967,0,0,81,0,-81
968,1,0,35,0,-35
969,0,0,23,0,-23
970,1,1,571,2057,1486
971,0,0,7,0,-7
972,0,0,73,0,-73
973,0,0,48,0,-48
974,1,0,21,0,-21
975,1,0,10,0,-10
976,1,0,67,0,-67
977,0,0,44,0,-44
978,0,0,27,0,-27
979,0,0,4,0,-4
980,0,0,64,0,-64
981,1,0,10,0,-10
982,1,1,142,2598,2456
983,0,0,57,0,-57
984,1,1,788,1202,414
985,0,0,262,0,-262
986,1,0,47,0,-47
987,1,0,51,0,-51
988,1,0,83,0,-83
989,0,0,76,0,-76
990,1,1,159,1202,1043
991,0,0,5,0,-5
992,1,0,49,0,-49
993,1,1,236,1459,1223
994,1,1,1211,1512,301
995,0,0,51,0,-51
996,0,0,31,0,-31
997,0,0,35,0,-35
998,1,1,173,1842,1669
999,0,0,49,0,-49
1000,1,0,57,0,-57
1001,1,0,2,0,-2
1002,0,0,1,0,-1
1003,1,1,467,1288,821
1004,1,1,311,2102,1791
1005,1,1,222,1234,1012
1006,1,0,140,0,-140
1007,0,0,12,0,-12
1008,1,1,625,1813,1188
1009,1,1,23,1404,1381
1010,1,0,27,0,-27
1011,0,0,42,0,-42
1012,1,0,47,0,-47
1013,1,1,62,1786,1724
1014,1,1,693,1735,1042
1015,1,0,9,0,-9
1016,0,0,24,0,-24
1017,1,0,63,0,-63
1018,0,0,35,0,-35
1019,1,1,2628,1512,-1116
1020,1,1,1096,1722,626
1021,0,0,47,0,-47
1022,1,1,199,2080,1881
1023,0,0,31,0,-31
1024,1,0,108,0,-108
1025,1,0,7,0,-7
1026,1,1,593,3748,3155
1027,1,0,74,0,-74
1028,1,0,300,0,-300
1029,0,0,10,0,-10
1030,0,0,85,0,-85
1031,1,0,46,0,-46
1032,0,0,45,0,-45
1033,1,1,632,2300,1668
1034,1,1,239,1417,1178
1035,1,1,12,2212,2200
1036,1,1,671,1588,917
1037,0,0,10,0,-10
1038,1,0,10,0,-10
1039,0,0,42,0,-42
1040,1,0,58,0,-58
1041,1,1,347,1289,942
1042,1,1,243,1691,1448
1043,1,1,196,1266,1070
1044,0,0,22,0,-22
1045,0,0,22,0,-22
1046,1,1,168,1281,1113
1047,0,0,14,0,-14
1048,1,1,84,1530,1446
1049,1,0,135,0,-135
1050,0,0,49,0,-49
1051,1,0,6,0,-6
1052,0,0,10,0,-10
1053,1,1,115,2242,2127
1054,1,1,221,1557,1336
1055,1,1,344,1377,1033
1056,0,0,36,0,-36
1057,1,0,34,0,-34
1058,0,0,53,0,-53
1059,0,0,86,0,-86
1060,1,1,596,1409,813
1061,1,0,58,0,-58
1062,0,0,15,0,-15
1063,0,0,76,0,-76
1064,0,0,41,0,-41
1065,0,0,53,0,-53
1066,0,0,15,0,-15
1067,0,0,25,0,-25
1068,1,1,80,2009,1929
1069,0,0,6,0,-6
1070,1,1,437,1466,1029
1071,0,0,40,0,-40
1072,0,0,172,0,-172
1073,0,0,95,0,-95
1074,1,0,5,0,-5
1075,0,0,67,0,-67
1076,0,0,9,0,-9
1077,1,1,1321,1623,302
1078,1,0,165,0,-165
1079,0,0,100,0,-100
1080,1,1,595,1562,967
1081,1,1,1668,2277,609
1082,1,1,218,1340,1122
1083,1,0,20,0,-20
1084,1,1,2158,1282,-876
1085,1,1,1600,1932,332
1086,1,1,355,2398,2043
1087,0,0,97,0,-97
1088,0,0,12,0,-12
1089,1,0,26,0,-26
1090,1,0,14,0,-14
1091,0,0,58,0,-58
1092,1,0,53,0,-53
1093,1,1,496,1618,1122
1094,1,1,234,1258,1024
1095,0,0,29,0,-29
1096,1,0,9,0,-9
1097,1,0,2,0,-2
1098,1,0,1,0,-1
1099,0,0,15,0,-15
1100,0,0,37,0,-37
1101,1,0,258,0,-258
1102,1,0,22,0,-22
1103,1,1,109,1405,1296
1104,1,0,106,0,-106
1105,1,0,34,0,-34
1106,1,0,54,0,-54
1107,1,1,63,1341,1278
1108,1,1,623,1455,832
1109,0,0,28,0,-28
1110,0,0,22,0,-22
1111,0,0,42,0,-42
1112,0,0,121,0,-121
1113,0,0,28,0,-28
1114,1,0,19,0,-19
1115,0,0,35,0,-35
1116,0,0,0,0,0
1117,0,0,7,0,-7
1118,0,0,7,0,-7
1119,0,0,19,0,-19
1120,1,1,976,1342,366
1121,0,0,10,0,-10
1122,1,1,657,1270,613
1123,1,1,244,1382,1138
1124,0,0,54,0,-54
1125,1,1,4206,1594,-2612
1126,1,0,44,0,-44
1127,1,0,72,0,-72
1128,1,1,79,2668,2589
1129,1,0,168,0,-168
1130,1,1,102,1414,1312
1131,0,0,51,0,-51
1132,0,0,9,0,-9
1133,1,1,743,1965,1222
1134,1,0,19,0,-19
1135,1,1,752,1397,645
1136,1,1,47,1322,1275
1137,0,0,51,0,-51
1138,1,0,24,0,-24
1139,0,0,57,0,-57
1140,1,0,22,0,-22
1141,0,0,214,0,-214
1142,1,0,13,0,-13
1143,0,0,9,0,-9
1144,1,0,44,0,-44
1145,0,0,71,0,-71
1146,0,0,32,0,-32
1147,1,0,35,0,-35
1148,1,0,120,0,-120
1149,0,0,58,0,-58
1150,1,1,679,1840,1161
1151,0,0,65,0,-65
1152,1,0,6,0,-6
1153,1,0,66,0,-66
1154,1,0,14,0,-14
1155,1,1,798,1268,470
1156,0,0,36,0,-36
1157,1,1,784,1303,519
1158,0,0,77,0,-77
1159,1,1,330,2281,1951
1160,0,0,1,0,-1
1161,1,1,474,1220,746
1162,0,0,136,0,-136
1163,1,0,131,0,-131
1164,1,0,36,0,-36
1165,1,1,112,1372,1260
1166,1,0,28,0,-28
1167,0,0,7,0,-7
1168,1,1,473,1220,747
1169,0,0,16,0,-16
1170,0,0,26,0,-26
1171,1,1,86,1648,1562
1172,1,1,1057,1415,358
1173,0,0,11,0,-11
1174,0,0,23,0,-23
1175,1,1,873,1641,768
1176,1,1,551,1265,714
1177,0,0,9,0,-9
1178,0,0,91,0,-91
1179,1,0,295,0,-295
1180,1,1,153,1659,1506
1181,1,1,209,1454,1245
1182,1,1,71,1847,1776
1183,1,0,59,0,-59
1184,1,1,114,1709,1595
1185,1,0,110,0,-110
1186,1,1,443,1371,928
1187,0,0,11,0,-11
1188,1,0,60,0,-60
1189,1,1,140,1336,1196
1190,1,0,23,0,-23
1191,1,1,710,1807,1097
1192,0,0,27,0,-27
1193,0,0,19,0,-19
1194,1,1,131,1388,1257
1195,1,1,467,1676,1209
1196,0,0,105,0,-105
1197,1,0,21,0,-21
1198,1,0,24,0,-24
1199,1,0,2,0,-2
1200,0,0,43,0,-43
1201,0,0,86,0,-86
1202,1,1,384,1229,845
1203,0,0,8,0,-8
1204,1,1,368,1374,1006
1205,1,1,130,1211,1081
1206,0,0,42,0,-42
1207,1,1,395,1580,1185
1208,1,0,51,0,-51
1209,0,0,21,0,-21
1210,0,0,7,0,-7
1211,1,0,87,0,-87
1212,0,0,147,0,-147
1213,1,1,1029,1255,226
1214,0,0,40,0,-40
1215,0,0,193,0,-193
1216,0,0,25,0,-25
1217,1,1,323,1377,1054
1218,1,1,415,1393,978
1219,1,1,798,1847,1049
1220,1,0,123,0,-123
1221,1,1,91,1540,1449
1222,1,0,120,0,-120
1223,0,0,42,0,-42
1224,1,1,54,1446,1392
1225,0,0,136,0,-136
1226,0,0,87,0,-87
1227,1,0,2,0,-2
1228,1,1,218,1231,1013
1229,0,0,1,0,-1
1230,0,0,45,0,-45
1231,0,0,117,0,-117
1232,0,0,44,0,-44
1233,1,1,480,1443,963
1234,1,0,9,0,-9
1235,1,0,12,0,-12
1236,0,0,29,0,-29
1237,0,0,10,0,-10
1238,1,0,24,0,-24
1239,0,0,26,0,-26
1240,0,0,8,0,-8
1241,1,0,94,0,-94
1242,0,0,8,0,-8
1243,1,0,13,0,-13
1244,0,0,49,0,-49
1245,0,0,40,0,-40
1246,0,0,24,0,-24
1247,1,0,4,0,-4
1248,0,0,28,0,-28
1249,1,1,182,1234,1052
1250,0,0,27,0,-27
1251,0,0,2,0,-2
1252,1,0,60,0,-60
1253,1,1,333,1342,1009
1254,0,0,6,0,-6
1255,1,0,40,0,-40
1256,1,0,183,0,-183
1257,0,0,5,0,-5
1258,0,0,46,0,-46
1259,0,0,150,0,-150
1260,0,0,44,0,-44
1261,0,0,21,0,-21
1262,1,0,38,0,-38
1263,1,0,8,0,-8
1264,0,0,5,0,-5
1265,0,0,57,0,-57
1266,0,0,77,0,-77
1267,0,0,127,0,-127
1268,1,1,1517,1293,-224
1269,1,1,812,1470,658
1270,0,0,1,0,-1
1271,0,0,64,0,-64
1272,0,0,4,0,-4
1273,1,0,103,0,-103
1274,0,0,17,0,-17
1275,1,1,180,1775,1595
1276,0,0,100,0,-100
1277,1,0,4,0,-4
1278,0,0,40,0,-40
1279,1,1,188,1202,1014
1280,1,1,720,1251,531
1281,1,1,362,1404,1042
1282,1,1,188,1308,1120
1283,1,1,1177,1212,35
1284,1,0,270,0,-270
1285,1,1,653,1391,738
1286,1,0,14,0,-14
1287,1,1,146,1383,1237
1288,1,0,47,0,-47
1289,0,0,12,0,-12
1290,1,1,195,1226,1031
1291,1,1,938,3617,2679
1292,1,0,104,0,-104
1293,1,0,38,0,-38
1294,0,0,1,0,-1
1295,1,1,271,1968,1697
1296,1,0,97,0,-97
1297,0,0,101,0,-101
1298,1,0,5,0,-5
1299,1,1,40,1266,1226
1300,1,1,327,2187,1860
1301,0,0,5,0,-5
1302,0,0,14,0,-14
1303,1,1,164,1715,1551
1304,1,0,52,0,-52
1305,0,0,137,0,-137
1306,0,0,17,0,-17
1307,0,0,71,0,-71
1308,0,0,12,0,-12
1309,1,0,79,0,-79
1310,1,0,8,0,-8
1311,1,0,18,0,-18
1312,1,1,658,1285,627
1313,0,0,214,0,-214
1314,1,1,837,1778,941
1315,0,0,52,0,-52
1316,0,0,9,0,-9
1317,0,0,6,0,-6
1318,0,0,54,0,-54
1319,1,1,408,1358,950
1320,0,0,9,0,-9
1321,0,0,11,0,-11
1322,1,0,48,0,-48
1323,0,0,1,0,-1
1324,1,1,149,2478,2329
1325,1,1,492,1463,971
1326,0,0,23,0,-23
1327,1,1,298,1412,1114
1328,0,0,38,0,-38
1329,0,0,39,0,-39
1330,1,1,291,2148,1857
1331,0,0,12,0,-12
1332,1,0,121,0,-121
1333,1,1,334,2341,2007
1334,0,0,16,0,-16
1335,0,0,30,0,-30
1336,1,1,863,1755,892
1337,1,0,29,0,-29
1338,1,0,67,0,-67
1339,1,0,118,0,-118
1340,1,1,461,1350,889
1341,0,0,10,0,-10
1342,0,0,38,0,-38
1343,1,0,39,0,-39
1344,1,0,64,0,-64
1345,1,1,312,1716,1404
1346,1,1,777,1392,615
1347,0,0,10,0,-10
1348,0,0,27,0,-27
1349,1,1,578,1226,648
1350,1,1,115,1206,1091
1351,0,0,65,0,-65
1352,1,0,6,0,-6
1353,1,1,290,1247,957
1354,1,1,678,2030,1352
1355,0,0,0,0,0
1356,1,0,0,0,0
1357,1,0,59,0,-59
1358,1,1,487,1370,883
1359,1,0,14,0,-14
1360,1,0,29,0,-29
1361,1,0,7,0,-7
1362,0,0,18,0,-18
1363,1,0,15,0,-15
1364,1,1,179,1557,1378
1365,0,0,1,0,-1
1366,1,1,1496,1320,-176
1367,0,0,58,0,-58
1368,0,0,402,0,-402
1369,0,0,7,0,-7
1370,1,1,843,1767,924
1371,0,0,33,0,-33
1372,0,0,4,0,-4
1373,1,0,0,0,0
1374,1,0,8,0,-8
1375,1,1,205,2114,1909
1376,1,1,2208,2037,-171
1377,1,1,657,1279,622
1378,0,0,129,0,-129
1379,1,1,169,1445,1276
1380,0,0,70,0,-70
1381,1,0,5,0,-5
1382,0,0,16,0,-16
1383,1,0,6,0,-6
1384,0,0,67,0,-67
1385,1,1,267,1215,948
1386,1,0,75,0,-75
1387,1,1,318,1227,909
1388,0,0,33,0,-33
1389,0,0,3,0,-3
1390,0,0,3,0,-3
1391,0,0,119,0,-119
1392,1,0,69,0,-69
1393,1,0,55,0,-55
1394,1,1,260,1271,1011
1395,0,0,16,0,-16
1396,0,0,38,0,-38
1397,1,1,162,1273,1111
1398,1,1,704,2134,1430
1399,1,1,222,1223,1001
1400,0,0,67,0,-67
1401,1,1,73,1614,1541
1402,0,0,148,0,-148
1403,1,1,1444,1309,-135
1404,0,0,6,0,-6
1405,0,0,67,0,-67
1406,1,1,254,1505,1251
1407,0,0,126,0,-126
1408,1,1,1117,1252,135
1409,0,0,74,0,-74
1410,1,0,2,0,-2
1411,0,0,20,0,-20
1412,1,0,72,0,-72
1413,0,0,3,0,-3
1414,1,0,77,0,-77
1415,0,0,47,0,-47
1416,1,0,62,0,-62
1417,1,1,298,2378,2080
1418,0,0,12,0,-12
1419,1,1,973,1609,636
1420,1,0,40,0,-40
1421,0,0,31,0,-31
1422,1,0,48,0,-48
1423,1,1,580,1694,1114
1424,1,1,673,1232,559
1425,1,1,859,1505,646
1426,1,1,320,1370,1050
1427,1,1,822,2291,1469
1428,1,0,196,0,-196
1429,1,1,763,1577,814
1430,0,0,8,0,-8
1431,0,0,213,0,-213
1432,1,0,91,0,-91
1433,1,1,970,1289,319
1434,0,0,90,0,-90
1435,1,0,258,0,-258
1436,1,1,210,1200,990
1437,0,0,93,0,-93
1438,0,0,1,0,-1
1439,0,0,19,0,-19
1440,1,1,258,1402,1144
1441,0,0,114,0,-114
1442,1,1,175,1658,1483
1443,1,0,35,0,-35
1444,1,0,167,0,-167
1445,0,0,39,0,-39
1446,0,0,99,0,-99
1447,1,0,2,0,-2
1448,0,0,28,0,-28
1449,1,0,30,0,-30
1450,1,0,8,0,-8
1451,0,0,36,0,-36
1452,1,0,6,0,-6
1453,1,0,99,0,-99
1454,0,0,62,0,-62
1455,1,1,570,3188,2618
1456,1,0,22,0,-22
1457,0,0,60,0,-60
1458,1,0,3,0,-3
1459,1,0,101,0,-101
1460,0,0,29,0,-29
1461,0,0,3,0,-3
1462,0,0,27,0,-27
1463,1,0,35,0,-35
1464,0,0,7,0,-7
1465,1,0,95,0,-95
1466,1,1,174,1810,1636
1467,1,1,760,1288,528
1468,0,0,16,0,-16
1469,0,0,24,0,-24
1470,0,0,1,0,-1
1471,1,0,11,0,-11
1472,0,0,31,0,-31
1473,1,1,522,1315,793
1474,0,0,43,0,-43
1475,1,0,99,0,-99
1476,1,1,97,1502,1405
1477,0,0,12,0,-12
1478,0,0,43,0,-43
1479,1,1,515,1811,1296
1480,1,1,454,1350,896
1481,0,0,20,0,-20
1482,1,0,6,0,-6
1483,0,0,39,0,-39
1484,0,0,75,0,-75
1485,0,0,121,0,-121
1486,0,0,65,0,-65
1487,0,0,69,0,-69
1488,0,0,63,0,-63
1489,1,1,662,1305,643
1490,1,0,68,0,-68
1491,1,1,462,1963,1501
1492,1,0,72,0,-72
1493,1,1,645,1263,618
1494,1,1,579,1730,1151
1495,0,0,67,0,-67
1496,0,0,102,0,-102
1497,1,0,9,0,-9
1498,1,1,345,1245,900
1499,1,0,12,0,-12
1500,1,0,41,0,-41
1501,1,1,261,1705,1444
1502,1,1,99,1285,1186
1503,1,0,75,0,-75
1504,1,1,493,1836,1343
1505,0,0,36,0,-36
1506,1,0,36,0,-36
1507,1,1,156,1283,1127
1508,0,0,84,0,-84
1509,1,1,201,1533,1332
1510,0,0,30,0,-30
1511,0,0,59,0,-59
1512,1,1,679,1226,547
1513,0,0,43,0,-43
1514,1,1,1617,1432,-185
1515,1,1,454,1529,1075
1516,0,0,133,0,-133
1517,0,0,99,0,-99
1518,1,1,907,1832,925
1519,1,0,11,0,-11
1520,1,0,39,0,-39
1521,0,0,3,0,-3
1522,1,0,22,0,-22
1523,1,0,170,0,-170
1524,1,0,40,0,-40
1525,1,0,31,0,-31
1526,0,0,40,0,-40
1527,0,0,44,0,-44
1528,0,0,113,0,-113
1529,0,0,11,0,-11
1530,1,1,68,1243,1175
1531,1,0,126,0,-126
1532,0,0,22,0,-22
1533,1,0,79,0,-79
1534,1,1,360,1483,1123
1535,0,0,160,0,-160
1536,1,0,109,0,-109
1537,1,1,549,1662,1113
1538,1,0,22,0,-22
1539,1,1,1216,1349,133
1540,1,1,589,1578,989
1541,0,0,58,0,-58
1542,1,1,227,2518,2291
1543,1,1,551,1338,787
1544,1,1,1834,1826,-8
1545,1,1,56,3170,3114
1546,0,0,30,0,-30
1547,0,0,14,0,-14
1548,0,0,164,0,-164
1549,1,0,10,0,-10
1550,1,1,485,1704,1219
1551,0,0,14,0,-14
1552,1,0,36,0,-36
1553,0,0,85,0,-85
1554,0,0,90,0,-90
1555,1,1,934,1378,444
1556,1,1,902,1237,335
1557,0,0,69,0,-69
1558,0,0,1,0,-1
1559,1,1,374,1250,876
1560,1,0,99,0,-99
1561,0,0,117,0,-117
1562,0,0,74,0,-74
1563,0,0,56,0,-56
1564,0,0,14,0,-14
1565,1,0,68,0,-68
1566,1,0,125,0,-125
1567,0,0,149,0,-149
1568,1,0,3,0,-3
1569,0,0,7,0,-7
1570,1,1,192,1420,1228
1571,0,0,39,0,-39
1572,1,0,153,0,-153
1573,0,0,85,0,-85
1574,1,0,66,0,-66
1575,0,0,69,0,-69
1576,1,0,95,0,-95
1577,0,0,3,0,-3
1578,1,1,876,1565,689
1579,1,1,487,2037,1550
1580,1,1,277,1399,1122
1581,1,1,229,1792,1563
1582,1,0,69,0,-69
1583,0,0,49,0,-49
1584,1,1,112,1451,1339
1585,1,0,38,0,-38
1586,0,0,51,0,-51
1587,1,1,607,1450,843
1588,0,0,26,0,-26
1589,1,1,1206,1268,62
1590,1,1,1071,1398,327
1591,1,1,1467,1485,18
1592,1,0,139,0,-139
1593,0,0,65,0,-65
1594,1,1,501,1251,750
1595,1,1,757,1784,1027
1596,0,0,38,0,-38
1597,1,1,178,1524,1346
1598,0,0,57,0,-57
1599,0,0,58,0,-58
1600,0,0,52,0,-52
1601,1,1,158,1444,1286
1602,1,0,80,0,-80
1603,1,0,45,0,-45
1604,1,0,89,0,-89
1605,0,0,32,0,-32
1606,1,1,542,1588,1046
1607,1,0,84,0,-84
1608,0,0,97,0,-97
1609,0,0,14,0,-14
1610,0,0,28,0,-28
1611,1,0,64,0,-64
1612,1,0,14,0,-14
1613,0,0,52,0,-52
1614,0,0,48,0,-48
1615,0,0,51,0,-51
1616,1,1,2059,1725,-334
1617,1,0,49,0,-49
1618,0,0,39,0,-39
1619,1,1,1437,1252,-185
1620,0,0,33,0,-33
1621,0,0,14,0,-14
1622,1,1,171,1656,1485
1623,1,0,168,0,-168
1624,1,0,42,0,-42
1625,0,0,9,0,-9
1626,0,0,18,0,-18
1627,0,0,7,0,-7
1628,1,1,1072,1496,424
1629,1,0,27,0,-27
1630,0,0,2,0,-2
1631,0,0,62,0,-62
1632,0,0,37,0,-37
1633,0,0,85,0,-85
1634,1,0,95,0,-95
1635,1,0,48,0,-48
1636,1,0,42,0,-42
1637,0,0,83,0,-83
1638,1,0,8,0,-8
1639,0,0,54,0,-54
1640,1,0,16,0,-16
1641,0,0,3,0,-3
1642,0,0,45,0,-45
1643,1,1,282,1208,926
1644,1,0,208,0,-208
1645,1,0,29,0,-29
1646,1,1,34,1439,1405
1647,1,0,12,0,-12
1648,1,1,635,1973,1338
1649,1,1,749,1453,704
1650,0,0,17,0,-17
1651,0,0,12,0,-12
1652,1,1,305,1455,1150
1653,1,0,47,0,-47
1654,1,0,2,0,-2
1655,1,1,1252,1527,275
1656,0,0,65,0,-65
1657,1,0,56,0,-56
1658,0,0,20,0,-20
1659,1,0,8,0,-8
1660,1,1,1187,1711,524
1661,1,1,312,1481,1169
1662,1,1,805,1443,638
1663,1,1,71,1313,1242
1664,0,0,1,0,-1
1665,1,1,451,1209,758
1666,0,0,4,0,-4
1667,1,0,39,0,-39
1668,0,0,20,0,-20
1669,1,0,3,0,-3
1670,0,0,79,0,-79
1671,1,1,839,1444,605
1672,0,0,11,0,-11
1673,1,0,16,0,-16
1674,0,0,38,0,-38
1675,0,0,45,0,-45
1676,0,0,8,0,-8
1677,1,0,20,0,-20
1678,1,1,1296,1265,-31
1679,1,1,889,1439,550
1680,0,0,65,0,-65
1681,1,0,108,0,-108
1682,1,1,734,1540,806
1683,0,0,79,0,-79
1684,1,0,65,0,-65
1685,0,0,5,0,-5
1686,1,1,1313,1876,563
1687,0,0,13,0,-13
1688,1,0,108,0,-108
1689,0,0,44,0,-44
1690,0,0,2,0,-2
1691,0,0,74,0,-74
1692,1,1,475,2487,2012
1693,0,0,2,0,-2
1694,0,0,58,0,-58
1695,1,1,185,1214,1029
1696,1,0,14,0,-14
1697,1,1,175,4775,4600
1698,0,0,240,0,-240
1699,1,1,179,1274,1095
1700,0,0,16,0,-16
1701,0,0,77,0,-77
1702,1,0,19,0,-19
1703,1,1,936,1650,714
1704,1,1,344,1264,920
1705,1,1,525,1218,693
1706,0,0,49,0,-49
1707,1,1,630,1633,1003
1708,1,0,23,0,-23
1709,0,0,1,0,-1
1710,0,0,97,0,-97
1711,0,0,5,0,-5
1712,1,1,1266,3632,2366
1713,0,0,32,0,-32
1714,1,0,25,0,-25
1715,0,0,56,0,-56
1716,0,0,270,0,-270
1717,1,0,6,0,-6
1718,0,0,48,0,-48
1719,0,0,34,0,-34
1720,1,0,13,0,-13
1721,0,0,6,0,-6
1722,0,0,176,0,-176
1723,1,1,71,1660,1589
1724,0,0,47,0,-47
1725,1,1,378,1250,872
1726,0,0,15,0,-15
1727,1,1,547,2553,2006
1728,1,0,92,0,-92
1729,1,0,0,0,0
1730,1,1,193,1561,1368
1731,0,0,18,0,-18
1732,1,1,661,1708,1047
1733,1,0,13,0,-13
1734,1,0,2,0,-2
1735,1,0,14,0,-14
1736,1,0,57,0,-57
1737,1,0,52,0,-52
1738,0,0,92,0,-92
1739,1,1,624,1444,820
1740,0,0,62,0,-62
1741,0,0,3,0,-3
1742,1,1,563,1319,756
1743,1,0,123,0,-123
1744,1,0,6,0,-6
1745,0,0,88,0,-88
1746,0,0,7,0,-7
1747,0,0,66,0,-66
1748,1,1,224,1247,1023
1749,0,0,140,0,-140
1750,1,0,36,0,-36
1751,0,0,38,0,-38
1752,0,0,73,0,-73
1753,0,0,148,0,-148
1754,1,1,364,1453,1089
1755,1,1,277,1369,1092
1756,1,1,613,2207,1594
1757,1,0,70,0,-70
1758,1,1,269,1328,1059
1759,1,1,104,1300,1196
1760,0,0,7,0,-7
1761,0,0,15,0,-15
1762,0,0,18,0,-18
1763,0,0,101,0,-101
1764,1,0,63,0,-63
1765,1,0,0,0,0
1766,0,0,8,0,-8
1767,0,0,109,0,-109
1768,1,0,11,0,-11
1769,1,0,28,0,-28
1770,1,1,1630,1472,-158
1771,1,0,1,0,-1
1772,1,1,40,1351,1311
1773,0,0,14,0,-14
1774,1,1,295,1543,1248
1775,1,0,40,0,-40
1776,1,0,123,0,-123
1777,0,0,137,0,-137
1778,1,0,106,0,-106
1779,1,0,11,0,-11
1780,1,0,28,0,-28
1781,1,0,22,0,-22
1782,0,0,4,0,-4
1783,1,1,166,1557,1391
1784,1,1,46,1303,1257
1785,0,0,58,0,-58
1786,1,1,266,1473,1207
1787,1,1,280,2328,2048
1788,0,0,19,0,-19
1789,0,0,19,0,-19
1790,0,0,37,0,-37
1791,1,0,206,0,-206
1792,1,0,72,0,-72
1793,0,0,10,0,-10
1794,1,1,388,1447,1059
1795,1,0,7,0,-7
1796,1,1,1357,1304,-53
1797,0,0,92,0,-92
1798,0,0,59,0,-59
1799,1,1,720,1220,500
1800,1,1,229,1858,1629
1801,0,0,106,0,-106
1802,1,1,177,1330,1153
1803,1,0,28,0,-28
1804,1,0,49,0,-49
1805,1,0,58,0,-58
1806,1,1,711,1681,970
1807,1,1,680,1333,653
1808,0,0,15,0,-15
1809,1,1,85,1890,1805
1810,1,0,16,0,-16
1811,0,0,38,0,-38
1812,1,0,29,0,-29
1813,0,0,14,0,-14
1814,0,0,6,0,-6
1815,1,0,27,0,-27
1816,1,0,82,0,-82
1817,1,1,151,1308,1157
1818,1,1,432,2019,1587
1819,0,0,36,0,-36
1820,1,1,399,1293,894
1821,1,1,317,1285,968
1822,1,1,369,3448,3079
1823,1,1,1315,1356,41
1824,0,0,59,0,-59
1825,0,0,96,0,-96
1826,1,0,259,0,-259
1827,0,0,161,0,-161
1828,0,0,4,0,-4
1829,0,0,112,0,-112
1830,0,0,180,0,-180
1831,0,0,73,0,-73
1832,1,0,100,0,-100
1833,1,1,244,2218,1974
1834,1,1,213,1363,1150
1835,1,0,58,0,-58
1836,0,0,9,0,-9
1837,0,0,8,0,-8
1838,0,0,5,0,-5
1839,1,1,172,1278,1106
1840,0,0,0,0,0
1841,0,0,23,0,-23
1842,0,0,16,0,-16
1843,0,0,47,0,-47
1844,1,0,35,0,-35
1845,0,0,22,0,-22
1846,1,1,383,1894,1511
1847,1,1,108,1302,1194
1848,0,0,107,0,-107
1849,0,0,67,0,-67
1850,1,1,178,2067,1889
1851,0,0,25,0,-25
1852,0,0,41,0,-41
1853,0,0,119,0,-119
1854,1,1,573,1595,1022
1855,1,1,440,1228,788
1856,1,0,9,0,-9
1857,0,0,128,0,-128
1858,1,0,0,0,0
1859,0,0,23,0,-23
1860,1,1,155,1581,1426
1861,0,0,13,0,-13
1862,1,1,199,1469,1270
1863,1,1,55,1917,1862
1864,0,0,12,0,-12
1865,1,1,893,1243,350
1866,1,1,409,1301,892
1867,1,1,253,1412,1159
1868,1,0,12,0,-12
1869,0,0,70,0,-70
1870,1,0,10,0,-10
1871,1,1,452,2227,1775
1872,1,0,253,0,-253
1873,0,0,126,0,-126
1874,0,0,26,0,-26
1875,1,1,1019,2519,1500
1876,1,0,52,0,-52
1877,0,0,2,0,-2
1878,1,1,64,2586,2522
1879,0,0,30,0,-30
1880,1,0,45,0,-45
1881,1,1,719,2311,1592
1882,1,0,2,0,-2
1883,1,1,225,1722,1497
1884,0,0,0,0,0
1885,1,1,301,1384,1083
1886,1,0,81,0,-81
1887,0,0,27,0,-27
1888,0,0,10,0,-10
1889,1,0,5,0,-5
1890,1,0,118,0,-118
1891,1,1,2598,1222,-1376
1892,1,0,97,0,-97
1893,1,0,11,0,-11
1894,0,0,2,0,-2
1895,0,0,155,0,-155
1896,0,0,7,0,-7
1897,1,1,327,2088,1761
1898,0,0,37,0,-37
1899,1,1,529,1230,701
1900,0,0,52,0,-52
1901,1,0,10,0,-10
1902,0,0,49,0,-49
1903,0,0,134,0,-134
1904,1,0,59,0,-59
1905,1,0,59,0,-59
1906,1,1,409,1339,930
1907,1,0,74,0,-74
1908,0,0,83,0,-83
1909,1,1,94,1210,1116
1910,1,0,17,0,-17
1911,1,0,89,0,-89
1912,0,0,2,0,-2
1913,1,1,99,1544,1445
1914,1,0,31,0,-31
1915,1,1,284,1492,1208
1916,1,0,10,0,-10
1917,1,1,261,2514,2253
1918,1,1,899,1680,781
1919,1,0,85,0,-85
1920,1,0,35,0,-35
1921,0,0,60,0,-60
1922,1,1,582,2338,1756
1923,0,0,97,0,-97
1924,1,0,63,0,-63
1925,0,0,11,0,-11
1926,1,0,35,0,-35
1927,1,1,763,1538,775
1928,1,0,5,0,-5
1929,0,0,16,0,-16
1930,0,0,121,0,-121
1931,1,1,674,1517,843
1932,1,0,40,0,-40
1933,1,0,13,0,-13
1934,1,0,6,0,-6
1935,0,0,75,0,-75
1936,0,0,123,0,-123
1937,0,0,12,0,-12
1938,0,0,75,0,-75
1939,1,0,1,0,-1
1940,1,1,36,1318,1282
1941,1,1,238,1297,1059
1942,1,0,64,0,-64
1943,1,1,90,1497,1407
1944,1,0,38,0,-38
1945,1,1,194,1333,1139
1946,1,1,41,1314,1273
1947,0,0,8,0,-8
1948,0,0,1,0,-1
1949,0,0,63,0,-63
1950,0,0,101,0,-101
1951,1,1,250,1308,1058
1952,0,0,0,0,0
1953,1,1,120,1539,1419
1954,1,0,29,0,-29
1955,1,0,6,0,-6
1956,0,0,213,0,-213
1957,1,0,9,0,-9
1958,0,0,26,0,-26
1959,0,0,73,0,-73
1960,1,1,89,1380,1291
1961,0,0,21,0,-21
1962,0,0,34,0,-34
1963,1,1,298,1266,968
1964,0,0,16,0,-16
1965,1,0,5,0,-5
1966,0,0,25,0,-25
1967,0,0,30,0,-30
1968,1,1,299,1312,1013
1969,1,1,1686,1335,-351
1970,1,1,97,1651,1554
1971,0,0,33,0,-33
1972,0,0,146,0,-146
1973,0,0,80,0,-80
1974,0,0,173,0,-173
1975,1,0,16,0,-16
1976,1,0,3,0,-3
1977,1,1,110,1351,1241
1978,0,0,115,0,-115
1979,0,0,9,0,-9
1980,0,0,8,0,-8
1981,1,1,176,1444,1268
1982,1,0,73,0,-73
1983,1,1,95,1968,1873
1984,1,0,28,0,-28
1985,1,1,739,1337,598
1986,0,0,132,0,-132
1987,1,0,30,0,-30
1988,1,1,166,1428,1262
1989,1,1,878,1302,424
1990,0,0,104,0,-104
1991,1,0,34,0,-34
1992,1,0,56,0,-56
1993,0,0,16,0,-16
1994,0,0,64,0,-64
1995,1,1,591,1457,866
1996,1,0,106,0,-106
1997,1,0,3,0,-3
1998,1,1,1006,1448,442
1999,1,1,773,1337,564
2000,0,0,6,0,-6
2001,1,0,67,0,-67
2002,0,0,3,0,-3
2003,0,0,23,0,-23
2004,0,0,158,0,-158
2005,0,0,9,0,-9
2006,1,0,104,0,-104
2007,1,1,83,1231,1148
2008,0,0,87,0,-87
2009,0,0,20,0,-20
2010,1,0,19,0,-19
2011,0,0,19,0,-19
2012,0,0,22,0,-22
2013,0,0,45,0,-45
2014,0,0,35,0,-35
2015,1,0,55,0,-55
2016,1,1,165,1204,1039
2017,0,0,26,0,-26
2018,1,0,34,0,-34
2019,1,1,481,1484,1003
2020,1,1,530,1418,888
2021,1,1,103,2047,1944
2022,0,0,20,0,-20
2023,1,0,6,0,-6
2024,0,0,90,0,-90
2025,1,0,22,0,-22
2026,0,0,16,0,-16
2027,1,0,38,0,-38
2028,0,0,15,0,-15
2029,0,0,88,0,-88
2030,0,0,10,0,-10
2031,1,1,543,1274,731
2032,1,1,2190,1483,-707
2033,1,0,137,0,-137
2034,0,0,1,0,-1
2035,1,0,23,0,-23
2036,0,0,95,0,-95
2037,0,0,73,0,-73
2038,0,0,5,0,-5
2039,0,0,34,0,-34
2040,0,0,10,0,-10
2041,1,0,80,0,-80
2042,1,1,369,1355,986
2043,1,1,628,1364,736
2044,1,0,37,0,-37
2045,0,0,40,0,-40
2046,1,0,204,0,-204
2047,1,1,644,1279,635
2048,0,0,10,0,-10
2049,0,0,6,0,-6
2050,1,0,168,0,-168
2051,1,1,885,1287,402
2052,1,1,35,1372,1337
2053,1,0,53,0,-53
2054,0,0,106,0,-106
2055,0,0,66,0,-66
2056,1,0,64,0,-64
2057,1,0,6,0,-6
2058,1,0,106,0,-106
2059,0,0,69,0,-69
2060,1,0,45,0,-45
2061,0,0,18,0,-18
2062,0,0,72,0,-72
2063,1,1,110,1215,1105
2064,1,0,24,0,-24
2065,1,1,689,1261,572
2066,0,0,64,0,-64
2067,0,0,19,0,-19
2068,0,0,1,0,-1
2069,1,0,53,0,-53
2070,1,1,62,1737,1675
2071,1,0,34,0,-34
2072,1,1,1349,1245,-104
2073,1,0,132,0,-132
2074,1,0,25,0,-25
2075,0,0,152,0,-152
2076,1,1,386,2514,2128
2077,1,1,205,1444,1239
2078,0,0,72,0,-72
2079,1,0,0,0,0
2080,1,1,105,1309,1204
2081,1,0,24,0,-24
2082,1,0,32,0,-32
2083,1,0,13,0,-13
2084,1,0,50,0,-50
2085,1,1,582,1553,971
2086,0,0,5,0,-5
2087,1,0,83,0,-83
2088,1,1,813,1244,431
2089,0,0,23,0,-23
2090,1,1,623,1322,699
2091,1,0,6,0,-6
2092,0,0,13,0,-13
2093,1,1,1294,1480,186
2094,1,0,185,0,-185
2095,1,0,9,0,-9
2096,0,0,6,0,-6
2097,0,0,13,0,-13
2098,1,0,5,0,-5
2099,1,1,326,1423,1097
2100,1,0,40,0,-40
2101,1,0,133,0,-133
2102,1,0,22,0,-22
2103,0,0,20,0,-20
2104,1,1,477,1328,851
2105,0,0,31,0,-31
2106,0,0,80,0,-80
2107,1,1,101,1781,1680
2108,1,0,24,0,-24
2109,0,0,51,0,-51
2110,0,0,62,0,-62
2111,0,0,12,0,-12
2112,1,1,531,1232,701
2113,0,0,32,0,-32
2114,1,0,4,0,-4
2115,0,0,5,0,-5
2116,1,1,771,1872,1101
2117,0,0,59,0,-59
2118,1,1,71,1324,1253
2119,1,0,26,0,-26
2120,1,1,256,1243,987
2121,1,0,17,0,-17
2122,0,0,28,0,-28
2123,1,0,56,0,-56
2124,1,1,128,1788,1660
2125,1,0,5,0,-5
2126,0,0,10,0,-10
2127,1,1,58,1608,1550
2128,1,0,109,0,-109
2129,1,0,64,0,-64
2130,0,0,28,0,-28
2131,1,0,13,0,-13
2132,0,0,28,0,-28
2133,0,0,21,0,-21
2134,1,1,907,1733,826
2135,1,1,524,2039,1515
2136,0,0,20,0,-20
2137,1,0,56,0,-56
2138,1,1,159,1211,1052
2139,1,1,1767,1413,-354
2140,0,0,36,0,-36
2141,0,0,55,0,-55
2142,1,0,0,0,0
2143,1,0,31,0,-31
2144,0,0,32,0,-32
2145,1,1,100,1697,1597
2146,0,0,42,0,-42
2147,1,1,123,1286,1163
2148,0,0,1,0,-1
2149,0,0,15,0,-15
2150,1,0,42,0,-42
2151,1,0,120,0,-120
2152,0,0,0,0,0
2153,1,1,155,1927,1772
2154,1,0,29,0,-29
2155,1,1,473,1833,1360
2156,1,0,35,0,-35
2157,1,1,177,1238,1061
2158,0,0,72,0,-72
2159,1,0,48,0,-48
2160,1,1,2214,2344,130
2161,0,0,8,0,-8
2162,1,1,118,1552,1434
2163,1,0,30,0,-30
2164,1,0,14,0,-14
2165,1,0,16,0,-16
2166,1,1,802,1573,771
2167,0,0,3,0,-3
2168,1,1,956,1627,671
2169,1,0,83,0,-83
2170,1,0,55,0,-55
2171,0,0,85,0,-85
2172,1,0,20,0,-20
2173,0,0,57,0,-57
2174,1,1,1998,1681,-317
2175,1,0,70,0,-70
2176,1,0,49,0,-49
2177,0,0,25,0,-25
2178,1,1,132,1270,1138
2179,0,0,95,0,-95
2180,1,1,953,1681,728
2181,0,0,25,0,-25
2182,1,1,683,1275,592
2183,0,0,1,0,-1
2184,0,0,108,0,-108
2185,1,1,860,1216,356
2186,0,0,218,0,-218
2187,0,0,24,0,-24
2188,0,0,47,0,-47
2189,1,0,23,0,-23
2190,1,1,616,1317,701
2191,1,0,1,0,-1
2192,1,1,580,1207,627
2193,1,0,2,0,-2
2194,0,0,5,0,-5
2195,1,1,588,1676,1088
2196,0,0,69,0,-69
2197,1,0,181,0,-181
2198,1,1,144,1667,1523
2199,0,0,16,0,-16
2200,1,0,60,0,-60
2201,1,0,147,0,-147
2202,0,0,1,0,-1
2203,1,1,219,1339,1120
2204,1,0,136,0,-136
2205,1,1,407,1973,1566
2206,1,1,60,1472,1412
2207,1,0,80,0,-80
2208,0,0,24,0,-24
2209,0,0,60,0,-60
2210,0,0,137,0,-137
2211,1,1,541,1207,666
2212,1,1,214,1337,1123
2213,0,0,27,0,-27
2214,1,0,44,0,-44
2215,0,0,20,0,-20
2216,0,0,22,0,-22
2217,0,0,3,0,-3
2218,0,0,152,0,-152
2219,0,0,14,0,-14
2220,1,1,393,1375,982
2221,0,0,101,0,-101
2222,1,0,118,0,-118
2223,0,0,42,0,-42
2224,1,0,133,0,-133
2225,0,0,95,0,-95
2226,1,0,29,0,-29
2227,1,1,101,1264,1163
2228,1,0,139,0,-139
2229,1,1,437,1270,833
2230,1,0,9,0,-9
2231,0,0,12,0,-12
2232,0,0,260,0,-260
2233,0,0,74,0,-74
2234,1,1,690,1558,868
2235,1,0,10,0,-10
2236,0,0,14,0,-14
2237,0,0,53,0,-53
2238,1,1,291,1354,1063
2239,0,0,2,0,-2
2240,0,0,2,0,-2
2241,1,1,610,1531,921
2242,1,0,1,0,-1
2243,1,0,130,0,-130
2244,1,1,321,1375,1054
2245,0,0,4,0,-4
2246,1,0,32,0,-32
2247,1,1,1136,1387,251
2248,1,0,10,0,-10
2249,1,0,58,0,-58
2250,1,0,14,0,-14
2251,0,0,41,0,-41
2252,1,1,134,1248,1114
2253,1,1,632,1296,664
2254,1,0,107,0,-107
2255,1,0,84,0,-84
2256,1,1,1695,1349,-346
2257,1,0,16,0,-16
2258,1,0,18,0,-18
2259,1,1,180,1568,1388
2260,0,0,29,0,-29
2261,1,0,24,0,-24
2262,1,1,176,1748,1572
2263,1,1,1429,1289,-140
2264,1,0,15,0,-15
2265,1,0,65,0,-65
2266,1,1,198,1643,1445
2267,1,1,166,1469,1303
2268,1,1,540,1326,786
2269,0,0,1,0,-1
2270,1,0,11,0,-11
2271,1,0,66,0,-66
2272,1,1,774,1230,456
2273,1,0,60,0,-60
2274,0,0,46,0,-46
2275,0,0,82,0,-82
2276,1,1,1051,1649,598
2277,0,0,13,0,-13
2278,0,0,31,0,-31
2279,1,0,23,0,-23
2280,0,0,14,0,-14
2281,1,0,50,0,-50
2282,0,0,76,0,-76
2283,0,0,36,0,-36
2284,1,1,758,1939,1181
2285,1,1,1276,1549,273
2286,1,0,39,0,-39
2287,1,1,40,2227,2187
2288,1,1,201,1322,1121
2289,1,1,40,1292,1252
2290,1,1,539,1488,949
2291,1,1,327,1418,1091
2292,1,0,116,0,-116
2293,1,0,56,0,-56
2294,0,0,25,0,-25
2295,0,0,29,0,-29
2296,0,0,9,0,-9
2297,1,1,1207,1239,32
2298,1,1,368,1228,860
2299,0,0,15,0,-15
2300,1,0,13,0,-13
2301,1,0,74,0,-74
2302,1,1,15,1458,1443
2303,1,0,76,0,-76
2304,0,0,52,0,-52
2305,1,1,226,1225,999
2306,0,0,18,0,-18
2307,1,0,103,0,-103
2308,1,0,15,0,-15
2309,0,0,63,0,-63
2310,0,0,29,0,-29
2311,0,0,11,0,-11
2312,1,1,33,1522,1489
2313,1,1,187,1444,1257
2314,1,1,1767,1339,-428
2315,1,1,478,1300,822
2316,0,0,14,0,-14
2317,1,1,100,1211,1111
2318,0,0,29,0,-29
2319,1,1,1941,1276,-665
2320,1,0,42,0,-42
2321,0,0,38,0,-38
2322,0,0,161,0,-161
2323,1,1,531,1232,701
2324,1,0,13,0,-13
2325,1,1,1023,1644,621
2326,0,0,33,0,-33
2327,1,0,14,0,-14
2328,0,0,18,0,-18
2329,1,0,31,0,-31
2330,0,0,4,0,-4
2331,1,0,7,0,-7
2332,1,0,21,0,-21
2333,0,0,51,0,-51
2334,1,0,84,0,-84
2335,1,1,398,1209,811
2336,1,1,567,1408,841
2337,1,0,269,0,-269
2338,0,0,2,0,-2
2339,1,1,181,1613,1432
2340,1,1,135,1523,1388
2341,0,0,31,0,-31
2342,0,0,4,0,-4
2343,1,0,43,0,-43
2344,1,1,186,2248,2062
2345,1,1,931,2325,1394
2346,1,0,85,0,-85
2347,1,1,841,1402,561
2348,1,0,25,0,-25
2349,0,0,60,0,-60
2350,0,0,16,0,-16
2351,1,1,220,1305,1085
2352,1,0,22,0,-22
2353,0,0,3,0,-3
2354,0,0,29,0,-29
2355,1,0,19,0,-19
2356,1,0,9,0,-9
2357,0,0,1,0,-1
2358,1,1,2878,1230,-1648
2359,0,0,7,0,-7
2360,1,1,236,1241,1005
2361,0,0,82,0,-82
2362,1,0,1,0,-1
2363,1,1,544,2549,2005
2364,1,0,99,0,-99
2365,1,0,11,0,-11
2366,1,1,224,1407,1183
2367,1,0,51,0,-51
2368,0,0,62,0,-62
2369,1,0,83,0,-83
2370,1,0,11,0,-11
2371,1,1,2206,1630,-576
2372,1,1,295,1517,1222
2373,1,0,29,0,-29
2374,1,1,1086,1327,241
2375,1,1,525,1494,969
2376,0,0,2,0,-2
2377,0,0,26,0,-26
2378,1,1,715,1310,595
2379,1,1,27,2545,2518
2380,1,0,17,0,-17
2381,1,0,51,0,-51
2382,1,1,185,1543,1358
2383,1,0,18,0,-18
2384,0,0,49,0,-49
2385,1,0,153,0,-153
2386,1,0,112,0,-112
2387,0,0,80,0,-80
2388,1,0,61,0,-61
2389,1,1,382,1827,1445
2390,0,0,45,0,-45
2391,1,1,557,1939,1382
2392,0,0,23,0,-23
2393,0,0,5,0,-5
2394,0,0,41,0,-41
2395,1,0,45,0,-45
2396,1,1,158,1210,1052
2397,1,0,102,0,-102
2398,1,1,253,1626,1373
2399,1,1,859,1289,430
2400,1,0,155,0,-155
2401,1,1,157,1239,1082
2402,1,1,187,2020,1833
2403,1,0,62,0,-62
2404,0,0,38,0,-38
2405,1,0,45,0,-45
2406,0,0,12,0,-12
2407,1,1,1653,2121,468
2408,1,1,1098,1261,163
2409,0,0,58,0,-58
2410,0,0,5,0,-5
2411,0,0,59,0,-59
2412,0,0,40,0,-40
2413,0,0,2,0,-2
2414,1,0,24,0,-24
2415,1,0,2,0,-2
2416,0,0,11,0,-11
2417,1,1,231,1316,1085
2418,1,0,33,0,-33
2419,0,0,60,0,-60
2420,0,0,3,0,-3
2421,1,0,29,0,-29
2422,0,0,71,0,-71
2423,1,0,12,0,-12
2424,1,1,345,1465,1120
2425,1,1,86,1793,1707
2426,1,1,214,1206,992
2427,1,0,111,0,-111
2428,1,0,9,0,-9
2429,0,0,140,0,-140
2430,1,1,254,1398,1144
2431,1,0,12,0,-12
2432,0,0,67,0,-67
2433,1,0,10,0,-10
2434,1,1,477,1483,1006
2435,1,1,131,1308,1177
2436,1,0,110,0,-110
2437,0,0,23,0,-23
2438,1,1,1227,1342,115
2439,1,1,325,1444,1119
2440,0,0,10,0,-10
2441,0,0,4,0,-4
2442,0,0,6,0,-6
2443,0,0,10,0,-10
2444,0,0,58,0,-58
2445,1,0,19,0,-19
2446,0,0,3,0,-3
2447,0,0,70,0,-70
2448,0,0,2,0,-2
2449,0,0,66,0,-66
2450,0,0,248,0,-248
2451,0,0,71,0,-71
2452,0,0,0,0,0
2453,1,1,308,1702,1394
2454,1,0,20,0,-20
2455,1,1,321,1360,1039
2456,0,0,184,0,-184
2457,0,0,66,0,-66
2458,0,0,8,0,-8
2459,1,1,144,1493,1349
2460,1,1,302,1850,1548
2461,0,0,3,0,-3
2462,1,0,90,0,-90
2463,1,0,107,0,-107
2464,1,1,65,1563,1498
2465,1,1,239,1283,1044
2466,1,1,779,1310,531
2467,1,1,1137,1506,369
2468,1,0,3,0,-3
2469,1,0,60,0,-60
2470,1,1,747,1259,512
2471,0,0,23,0,-23
2472,1,1,209,1619,1410
2473,1,1,59,1533,1474
2474,0,0,37,0,-37
2475,0,0,24,0,-24
2476,0,0,1,0,-1
2477,1,0,14,0,-14
2478,1,1,68,1217,1149
2479,0,0,100,0,-100
2480,1,1,136,6627,6491
2481,1,1,1546,1214,-332
2482,1,1,82,1217,1135
2483,1,1,265,1505,1240
2484,1,1,375,1565,1190
2485,1,1,237,1538,1301
2486,0,0,25,0,-25
2487,1,0,3,0,-3
2488,0,0,98,0,-98
2489,1,1,744,1229,485
2490,1,1,223,1733,1510
2491,1,0,56,0,-56
2492,1,1,3542,1310,-2232
2493,1,1,202,1702,1500
2494,1,1,458,1717,1259
2495,0,0,18,0,-18
2496,1,0,51,0,-51
2497,1,1,462,1630,1168
2498,1,1,133,1613,1480
2499,1,1,247,1385,1138
2500,0,0,4,0,-4
2501,0,0,16,0,-16
2502,1,0,4,0,-4
2503,0,0,11,0,-11
2504,1,0,3,0,-3
2505,0,0,55,0,-55
2506,1,0,219,0,-219
2507,1,0,160,0,-160
2508,1,1,681,1317,636
2509,1,1,105,2687,2582
2510,0,0,41,0,-41
2511,0,0,28,0,-28
2512,0,0,89,0,-89
2513,0,0,1,0,-1
2514,1,1,479,1912,1433
2515,0,0,43,0,-43
2516,0,0,108,0,-108
2517,0,0,18,0,-18
2518,0,0,82,0,-82
2519,0,0,26,0,-26
2520,1,0,65,0,-65
2521,1,0,18,0,-18
2522,1,0,21,0,-21
2523,1,0,16,0,-16
2524,1,1,292,1270,978
2525,1,1,2854,1428,-1426
2526,1,1,294,1278,984
2527,1,1,176,1330,1154
2528,1,0,1,0,-1
2529,0,0,162,0,-162
2530,0,0,19,0,-19
2531,1,0,37,0,-37
2532,0,0,4,0,-4
2533,1,0,113,0,-113
2534,1,1,245,1515,1270
2535,1,0,271,0,-271
2536,0,0,160,0,-160
2537,1,0,38,0,-38
2538,1,1,348,1210,862
2539,1,1,501,4261,3760
2540,1,0,102,0,-102
2541,1,0,68,0,-68
2542,1,1,536,1410,874
2543,1,1,13,1833,1820
2544,1,0,24,0,-24
2545,1,1,1039,1350,311
2546,1,1,146,1215,1069
2547,1,0,56,0,-56
2548,1,0,25,0,-25
2549,1,1,168,1209,1041
2550,1,1,332,1236,904
2551,1,1,685,1311,626
2552,1,0,196,0,-196
2553,0,0,49,0,-49
2554,0,0,10,0,-10
2555,0,0,28,0,-28
2556,0,0,17,0,-17
2557,0,0,30,0,-30
2558,1,0,31,0,-31
2559,0,0,28,0,-28
2560,0,0,36,0,-36
2561,0,0,0,0,0
2562,0,0,7,0,-7
2563,1,0,70,0,-70
2564,1,1,454,1499,1045
2565,1,0,57,0,-57
2566,1,0,29,0,-29
2567,0,0,93,0,-93
2568,1,0,6,0,-6
2569,1,0,16,0,-16
2570,1,0,19,0,-19
2571,1,0,22,0,-22
2572,1,1,1508,1759,251
2573,0,0,32,0,-32
2574,0,0,22,0,-22
2575,0,0,27,0,-27
2576,0,0,27,0,-27
2577,1,0,195,0,-195
2578,1,1,66,1562,1496
2579,1,0,69,0,-69
2580,1,0,40,0,-40
2581,1,0,26,0,-26
2582,1,0,39,0,-39
2583,1,0,36,0,-36
2584,0,0,2,0,-2
2585,1,1,214,1833,1619
2586,0,0,0,0,0
2587,1,1,103,2050,1947
2588,1,0,18,0,-18
2589,1,0,39,0,-39
2590,1,0,2,0,-2
2591,0,0,6,0,-6
2592,1,0,33,0,-33
2593,1,1,792,2171,1379
2594,0,0,23,0,-23
2595,1,1,78,1541,1463
2596,0,0,2,0,-2
2597,1,1,1350,1400,50
2598,0,0,21,0,-21
2599,1,0,1,0,-1
2600,0,0,46,0,-46
2601,0,0,6,0,-6
2602,0,0,8,0,-8
2603,1,1,274,1244,970
2604,1,1,25,1352,1327
2605,0,0,101,0,-101
2606,1,0,4,0,-4
2607,1,1,319,1292,973
2608,1,0,4,0,-4
2609,0,0,35,0,-35
2610,0,0,119,0,-119
2611,1,1,1012,1232,220
2612,1,1,1046,1361,315
2613,1,0,28,0,-28
2614,0,0,52,0,-52
2615,1,1,654,1442,788
2616,1,0,58,0,-58
2617,1,0,123,0,-123
2618,1,1,177,1695,1518
2619,0,0,3,0,-3
2620,1,1,582,2058,1476
2621,1,1,324,1281,957
2622,1,1,977,3027,2050
2623,1,1,244,1247,1003
2624,1,0,28,0,-28
2625,1,1,235,1597,1362
2626,1,1,225,1666,1441
2627,1,1,868,1238,370
2628,1,1,2153,1515,-638
2629,0,0,64,0,-64
2630,1,1,1306,1204,-102
2631,1,0,11,0,-11
2632,0,0,221,0,-221
2633,1,1,87,2374,2287
2634,1,1,294,1270,976
2635,1,0,29,0,-29
2636,0,0,25,0,-25
2637,1,1,1300,1279,-21
2638,1,0,30,0,-30
2639,0,0,10,0,-10
2640,1,1,652,1462,810
2641,1,1,80,1412,1332
2642,1,1,1086,1701,615
2643,0,0,94,0,-94
2644,0,0,100,0,-100
2645,0,0,13,0,-13
2646,0,0,123,0,-123
2647,1,0,64,0,-64
2648,1,0,101,0,-101
2649,1,1,1690,1390,-300
2650,0,0,164,0,-164
2651,1,0,21,0,-21
2652,0,0,20,0,-20
2653,1,0,100,0,-100
2654,0,0,22,0,-22
2655,1,1,60,2040,1980
2656,1,0,102,0,-102
2657,1,1,597,1988,1391
2658,1,1,218,1283,1065
2659,1,1,272,1471,1199
2660,1,1,948,1605,657
2661,1,0,23,0,-23
2662,0,0,58,0,-58
2663,0,0,136,0,-136
2664,0,0,125,0,-125
2665,1,0,103,0,-103
2666,1,1,404,1454,1050
2667,0,0,53,0,-53
2668,0,0,41,0,-41
2669,1,1,249,1389,1140
2670,1,1,540,2168,1628
2671,0,0,26,0,-26
2672,1,1,449,2070,1621
2673,1,1,226,1467,1241
2674,1,0,14,0,-14
2675,1,0,59,0,-59
2676,1,0,64,0,-64
2677,0,0,94,0,-94
2678,1,1,297,1464,1167
2679,1,0,24,0,-24
2680,1,0,9,0,-9
2681,0,0,1,0,-1
2682,1,0,55,0,-55
2683,1,1,199,1731,1532
2684,1,0,62,0,-62
2685,0,0,41,0,-41
2686,1,0,39,0,-39
2687,1,1,168,1571,1403
2688,1,0,122,0,-122
2689,0,0,55,0,-55
2690,1,0,9,0,-9
2691,1,0,12,0,-12
2692,1,0,7,0,-7
2693,1,1,733,1301,568
2694,1,0,87,0,-87
2695,1,1,1576,2723,1147
2696,0,0,47,0,-47
2697,1,0,114,0,-114
2698,1,1,996,1446,450
2699,1,0,65,0,-65
2700,0,0,28,0,-28
2701,1,0,67,0,-67
2702,0,0,1,0,-1
2703,1,0,11,0,-11
2704,1,0,4,0,-4
2705,1,1,375,3124,2749
2706,1,1,1088,1492,404
2707,1,1,207,2041,1834
2708,0,0,199,0,-199
2709,1,0,2,0,-2
2710,1,0,69,0,-69
2711,1,1,1334,1243,-91
2712,0,0,15,0,-15
2713,1,0,27,0,-27
2714,0,0,40,0,-40
2715,0,0,108,0,-108
2716,0,0,13,0,-13
2717,1,1,1906,1225,-681
2718,0,0,16,0,-16
2719,1,1,94,1319,1225
2720,1,1,482,1918,1436
2721,1,0,105,0,-105
2722,1,1,643,4950,4307
2723,1,0,8,0,-8
2724,0,0,87,0,-87
2725,0,0,62,0,-62
2726,1,1,266,1210,944
2727,1,1,447,1942,1495
2728,1,0,91,0,-91
2729,1,1,126,1346,1220
2730,1,0,35,0,-35
2731,0,0,25,0,-25
2732,0,0,32,0,-32
2733,1,1,134,1945,1811
2734,1,0,2,0,-2
2735,1,1,390,2075,1685
2736,0,0,14,0,-14
2737,1,0,22,0,-22
2738,0,0,67,0,-67
2739,1,0,29,0,-29
2740,0,0,27,0,-27
2741,0,0,43,0,-43
2742,1,1,88,1617,1529
2743,0,0,9,0,-9
2744,1,1,246,2044,1798
2745,1,1,715,1487,772
2746,0,0,83,0,-83
2747,1,1,104,1302,1198
2748,0,0,9,0,-9
2749,1,1,2556,1411,-1145
2750,0,0,25,0,-25
2751,1,0,7,0,-7
2752,0,0,147,0,-147
2753,0,0,156,0,-156
2754,1,1,249,1876,1627
2755,0,0,3,0,-3
2756,0,0,6,0,-6
2757,1,1,1354,1365,11
2758,1,0,27,0,-27
2759,1,0,18,0,-18
2760,1,0,14,0,-14
2761,1,0,99,0,-99
2762,1,1,362,1661,1299
2763,1,0,195,0,-195
2764,1,0,12,0,-12
2765,1,0,55,0,-55
2766,1,1,686,1264,578
2767,1,1,183,1231,1048
2768,1,0,45,0,-45
2769,0,0,28,0,-28
2770,0,0,14,0,-14
2771,1,0,62,0,-62
2772,0,0,62,0,-62
2773,0,0,40,0,-40
2774,1,1,151,1306,1155
2775,1,1,1181,1968,787
2776,1,0,10,0,-10
2777,1,0,9,0,-9
2778,0,0,9,0,-9
2779,0,0,72,0,-72
2780,1,1,86,1341,1255
2781,0,0,0,0,0
2782,1,1,886,1464,578
2783,1,1,423,1627,1204
2784,0,0,80,0,-80
2785,1,1,1409,1530,121
2786,1,1,181,1914,1733
2787,1,1,222,2333,2111
2788,1,0,10,0,-10
2789,1,1,700,2688,1988
2790,1,1,1135,1279,144
2791,1,1,464,1895,1431
2792,1,0,31,0,-31
2793,0,0,80,0,-80
2794,1,0,1,0,-1
2795,0,0,18,0,-18
2796,1,1,100,2646,2546
2797,1,0,13,0,-13
2798,1,0,62,0,-62
2799,0,0,8,0,-8
2800,0,0,24,0,-24
2801,1,1,196,2074,1878
2802,0,0,15,0,-15
2803,1,0,242,0,-242
2804,1,1,42,2030,1988
2805,0,0,319,0,-319
2806,1,1,172,1554,1382
2807,1,0,23,0,-23
2808,0,0,18,0,-18
2809,0,0,87,0,-87
2810,1,0,83,0,-83
2811,1,0,38,0,-38
2812,1,1,450,1572,1122
2813,0,0,39,0,-39
2814,1,1,1042,1453,411
2815,1,0,28,0,-28
2816,0,0,20,0,-20
2817,1,1,374,2795,2421
2818,1,0,2,0,-2
2819,0,0,22,0,-22
2820,0,0,25,0,-25
2821,0,0,25,0,-25
2822,1,1,66,4109,4043
2823,1,1,199,1487,1288
2824,1,1,1356,1299,-57
2825,1,1,720,1253,533
2826,1,0,25,0,-25
2827,0,0,72,0,-72
2828,1,0,43,0,-43
2829,1,1,142,2337,2195
2830,0,0,73,0,-73
2831,0,0,35,0,-35
2832,0,0,28,0,-28
2833,0,0,64,0,-64
2834,0,0,28,0,-28
2835,0,0,4,0,-4
2836,0,0,24,0,-24
2837,1,1,225,1536,1311
2838,1,1,149,1380,1231
2839,0,0,79,0,-79
2840,0,0,16,0,-16
2841,0,0,81,0,-81
2842,0,0,101,0,-101
2843,0,0,13,0,-13
2844,1,0,84,0,-84
2845,0,0,47,0,-47
2846,0,0,57,0,-57
2847,0,0,28,0,-28
2848,1,0,17,0,-17
2849,0,0,159,0,-159
2850,0,0,2,0,-2
2851,0,0,118,0,-118
2852,1,1,528,1291,763
2853,1,0,144,0,-144
2854,0,0,4,0,-4
2855,1,0,187,0,-187
2856,0,0,152,0,-152
2857,0,0,9,0,-9
2858,0,0,16,0,-16
2859,0,0,51,0,-51
2860,1,1,111,1204,1093
2861,0,0,9,0,-9
2862,1,0,11,0,-11
2863,0,0,43,0,-43
2864,1,1,303,1352,1049
2865,1,1,830,1294,464
2866,1,1,760,1234,474
2867,1,0,90,0,-90
2868,0,0,50,0,-50
2869,0,0,7,0,-7
2870,1,0,44,0,-44
2871,0,0,110,0,-110
2872,1,1,1578,2835,1257
2873,1,0,5,0,-5
2874,1,0,52,0,-52
2875,0,0,23,0,-23
2876,0,0,193,0,-193
2877,1,0,137,0,-137
2878,0,0,21,0,-21
2879,0,0,40,0,-40
2880,1,0,19,0,-19
2881,0,0,60,0,-60
2882,1,0,11,0,-11
2883,1,1,345,2672,2327
2884,0,0,96,0,-96
2885,0,0,38,0,-38
2886,1,0,69,0,-69
2887,0,0,2,0,-2
2888,1,0,72,0,-72
2889,1,1,182,1224,1042
2890,0,0,52,0,-52
2891,1,0,27,0,-27
2892,1,1,713,1259,546
2893,1,0,31,0,-31
2894,1,0,16,0,-16
2895,1,1,1948,1602,-346
2896,1,1,563,1224,661
2897,0,0,17,0,-17
2898,1,1,735,1600,865
2899,0,0,89,0,-89
2900,0,0,90,0,-90
2901,1,0,121,0,-121
2902,1,1,489,1218,729
2903,1,1,541,1806,1265
2904,1,1,519,1284,765
2905,1,0,14,0,-14
2906,1,0,37,0,-37
2907,0,0,19,0,-19
2908,1,1,756,1712,956
2909,1,1,653,1739,1086
2910,1,0,11,0,-11
2911,0,0,46,0,-46
2912,1,0,32,0,-32
2913,1,0,25,0,-25
2914,1,0,47,0,-47
2915,1,0,59,0,-59
2916,1,0,38,0,-38
2917,1,1,28,1925,1897
2918,1,1,656,1465,809
2919,0,0,20,0,-20
2920,0,0,5,0,-5
2921,0,0,23,0,-23
2922,0,0,141,0,-141
2923,1,1,143,1290,1147
2924,1,1,1793,1631,-162
2925,1,0,103,0,-103
2926,1,1,150,1424,1274
2927,1,1,690,1437,747
2928,0,0,0,0,0
2929,1,1,274,1319,1045
2930,1,1,421,1695,1274
2931,1,0,70,0,-70
2932,1,0,27,0,-27
2933,0,0,64,0,-64
2934,1,1,104,1229,1125
2935,1,0,14,0,-14
2936,1,0,13,0,-13
2937,0,0,71,0,-71
2938,1,1,429,1310,881
2939,1,1,3379,3647,268
2940,1,1,495,1243,748
2941,1,0,88,0,-88
2942,1,1,111,1646,1535
2943,1,1,250,2845,2595
2944,0,0,54,0,-54
2945,1,0,10,0,-10
2946,1,0,85,0,-85
2947,1,1,1355,1304,-51
2948,1,1,359,1232,873
2949,1,1,698,1213,515
2950,1,1,1286,1289,3
2951,1,0,191,0,-191
2952,0,0,31,0,-31
2953,0,0,30,0,-30
2954,1,1,687,1273,586
2955,0,0,5,0,-5
2956,1,1,144,1363,1219
2957,0,0,12,0,-12
2958,0,0,84,0,-84
2959,1,1,1370,3919,2549
2960,1,1,79,1379,1300
2961,1,1,257,1554,1297
2962,1,1,944,1734,790
2963,0,0,34,0,-34
2964,0,0,239,0,-239
2965,0,0,5,0,-5
2966,0,0,135,0,-135
2967,1,0,3,0,-3
2968,1,1,873,2428,1555
2969,0,0,30,0,-30
2970,0,0,13,0,-13
2971,0,0,21,0,-21
2972,0,0,84,0,-84
2973,1,1,1051,1330,279
2974,0,0,17,0,-17
2975,1,0,101,0,-101
2976,1,0,21,0,-21
2977,1,0,44,0,-44
2978,1,1,797,1382,585
2979,1,1,423,1954,1531
2980,0,0,46,0,-46
2981,1,0,68,0,-68
2982,0,0,5,0,-5
2983,1,1,361,1257,896
2984,1,0,13,0,-13
2985,1,0,63,0,-63
2986,0,0,48,0,-48
2987,1,1,853,2173,1320
2988,1,1,427,2852,2425
2989,0,0,4,0,-4
2990,1,0,2,0,-2
2991,1,1,1454,2640,1186
2992,1,0,32,0,-32
2993,1,1,980,1271,291
2994,0,0,23,0,-23
2995,1,1,462,1544,1082
2996,1,1,964,1839,875
2997,1,0,72,0,-72
2998,1,0,55,0,-55
2999,1,1,154,1210,1056
3000,1,0,73,0,-73
3001,0,0,99,0,-99
3002,1,0,5,0,-5
3003,1,0,4,0,-4
3004,0,0,4,0,-4
3005,1,1,489,3465,2976
3006,0,0,44,0,-44
3007,0,0,39,0,-39
3008,0,0,32,0,-32
3009,0,0,52,0,-52
3010,1,1,791,1302,511
3011,1,1,62,2211,2149
3012,1,1,1103,1372,269
3013,1,1,490,1610,1120
3014,1,1,273,1521,1248
3015,1,1,929,1896,967
3016,1,0,86,0,-86
3017,1,1,1372,1333,-39
3018,1,0,62,0,-62
3019,0,0,27,0,-27
3020,1,1,999,1597,598
3021,1,1,448,1249,801
3022,0,0,2,0,-2
3023,1,0,10,0,-10
3024,1,1,363,1301,938
3025,1,0,12,0,-12
3026,1,1,1084,1233,149
3027,0,0,110,0,-110
3028,1,0,14,0,-14
3029,1,1,670,1589,919
3030,0,0,91,0,-91
3031,1,1,861,1502,641
3032,1,0,11,0,-11
3033,1,0,15,0,-15
3034,0,0,20,0,-20
3035,0,0,38,0,-38
3036,1,1,219,1799,1580
3037,1,1,1185,1267,82
3038,1,1,358,1715,1357
3039,0,0,56,0,-56
3040,1,1,816,1467,651
3041,0,0,29,0,-29
3042,0,0,11,0,-11
3043,0,0,95,0,-95
3044,1,0,47,0,-47
3045,1,1,593,1594,1001
3046,1,1,979,2089,1110
3047,0,0,192,0,-192
3048,0,0,0,0,0
3049,0,0,21,0,-21
3050,1,0,39,0,-39
3051,1,1,1106,2496,1390
3052,1,0,2,0,-2
3053,1,0,6,0,-6
3054,1,0,10,0,-10
3055,1,0,71,0,-71
3056,1,0,2,0,-2
3057,1,1,408,1215,807
3058,0,0,106,0,-106
3059,0,0,46,0,-46
3060,0,0,15,0,-15
3061,0,0,20,0,-20
3062,0,0,36,0,-36
3063,0,0,150,0,-150
3064,0,0,59,0,-59
3065,1,1,161,1393,1232
3066,0,0,98,0,-98
3067,0,0,31,0,-31
3068,1,1,126,1454,1328
3069,0,0,81,0,-81
3070,1,0,43,0,-43
3071,1,1,318,1869,1551
3072,0,0,45,0,-45
3073,1,1,947,1888,941
3074,1,1,498,1600,1102
3075,1,1,484,1302,818
3076,1,1,272,1559,1287
3077,0,0,3,0,-3
3078,1,0,6,0,-6
3079,1,1,179,1735,1556
3080,1,1,227,1290,1063
3081,1,0,78,0,-78
3082,1,1,283,1207,924
3083,0,0,39,0,-39
3084,1,0,4,0,-4
3085,1,0,29,0,-29
3086,0,0,43,0,-43
3087,1,0,10,0,-10
3088,1,1,66,1422,1356
3089,0,0,84,0,-84
3090,1,0,29,0,-29
3091,1,0,30,0,-30
3092,0,0,14,0,-14
3093,1,0,15,0,-15
3094,1,1,151,1289,1138
3095,0,0,61,0,-61
3096,0,0,199,0,-199
3097,1,0,6,0,-6
3098,1,1,840,1285,445
3099,1,0,7,0,-7
3100,0,0,106,0,-106
3101,0,0,174,0,-174
3102,0,0,47,0,-47
3103,1,0,46,0,-46
3104,0,0,180,0,-180
3105,1,1,238,1860,1622
3106,1,0,21,0,-21
3107,1,0,17,0,-17
3108,1,0,10,0,-10
3109,1,1,644,1568,924
3110,1,0,20,0,-20
3111,1,1,1162,1382,220
3112,0,0,53,0,-53
3113,0,0,3,0,-3
3114,0,0,93,0,-93
3115,1,0,116,0,-116
3116,0,0,99,0,-99
3117,1,0,12,0,-12
3118,1,0,0,0,0
3119,1,1,98,1302,1204
3120,1,1,298,1271,973
3121,0,0,78,0,-78
3122,1,0,23,0,-23
3123,1,0,69,0,-69
3124,1,0,173,0,-173
3125,1,1,2315,1239,-1076
3126,0,0,132,0,-132
3127,1,0,17,0,-17
3128,0,0,110,0,-110
3129,0,0,68,0,-68
3130,1,1,129,1694,1565
3131,0,0,20,0,-20
3132,1,1,684,1642,958
3133,1,1,107,1453,1346
3134,0,0,65,0,-65
3135,1,1,1444,1348,-96
3136,1,0,4,0,-4
3137,1,0,90,0,-90
3138,1,1,310,1455,1145
3139,1,1,98,1571,1473
3140,0,0,41,0,-41
3141,1,1,1093,1305,212
3142,1,0,68,0,-68
3143,1,1,51,2656,2605
3144,1,0,19,0,-19
3145,1,1,202,1321,1119
3146,1,0,36,0,-36
3147,1,1,137,1315,1178
3148,1,0,10,0,-10
3149,0,0,85,0,-85
3150,0,0,63,0,-63
3151,1,1,418,2811,2393
3152,1,1,2478,1331,-1147
3153,0,0,126,0,-126
3154,0,0,12,0,-12
3155,1,1,223,1774,1551
3156,0,0,58,0,-58
3157,1,0,10,0,-10
3158,0,0,94,0,-94
3159,0,0,19,0,-19
3160,1,1,122,1949,1827
3161,0,0,45,0,-45
3162,1,1,230,1380,1150
3163,0,0,8,0,-8
3164,1,0,48,0,-48
3165,0,0,1,0,-1
3166,1,0,122,0,-122
3167,1,1,697,1420,723
3168,1,0,50,0,-50
3169,0,0,17,0,-17
3170,1,1,1052,1331,279
3171,1,0,34,0,-34
3172,0,0,67,0,-67
3173,1,0,12,0,-12
3174,1,0,71,0,-71
3175,1,0,49,0,-49
3176,1,1,428,1657,1229
3177,1,1,1046,1360,314
3178,0,0,60,0,-60
3179,0,0,5,0,-5
3180,1,0,8,0,-8
3181,0,0,22,0,-22
3182,0,0,7,0,-7
3183,1,0,3,0,-3
3184,1,0,32,0,-32
3185,1,1,554,1272,718
3186,1,0,14,0,-14
3187,1,1,203,1665,1462
3188,0,0,114,0,-114
3189,0,0,7,0,-7
3190,1,1,55,1756,1701
3191,0,0,9,0,-9
3192,0,0,82,0,-82
3193,0,0,230,0,-230
3194,1,0,32,0,-32
3195,1,0,3,0,-3
3196,1,1,562,1250,688
3197,0,0,43,0,-43
3198,0,0,115,0,-115
3199,0,0,15,0,-15
3200,1,0,72,0,-72
3201,1,1,170,1375,1205
3202,1,1,144,2661,2517
3203,1,1,149,1611,1462
3204,1,0,75,0,-75
3205,0,0,14,0,-14
3206,0,0,29,0,-29
3207,1,1,63,2382,2319
3208,1,0,139,0,-139
3209,1,0,19,0,-19
3210,1,0,43,0,-43
3211,1,1,960,1414,454
3212,1,0,11,0,-11
3213,1,1,609,1216,607
3214,1,1,15,1687,1672
3215,0,0,120,0,-120
3216,0,0,70,0,-70
3217,0,0,181,0,-181
3218,1,0,18,0,-18
3219,0,0,36,0,-36
3220,1,1,137,1247,1110
3221,0,0,31,0,-31
3222,0,0,18,0,-18
3223,1,0,81,0,-81
3224,1,0,32,0,-32
3225,1,1,1265,1397,132
3226,1,1,47,1232,1185
3227,0,0,85,0,-85
3228,0,0,19,0,-19
3229,1,1,289,1250,961
3230,1,0,8,0,-8
3231,0,0,3,0,-3
3232,0,0,8,0,-8
3233,1,0,25,0,-25
3234,0,0,61,0,-61
3235,0,0,56,0,-56
3236,1,0,2,0,-2
3237,0,0,47,0,-47
3238,1,1,200,1792,1592
3239,1,1,230,1400,1170
3240,1,0,73,0,-73
3241,0,0,1,0,-1
3242,1,0,42,0,-42
3243,1,0,20,0,-20
3244,0,0,30,0,-30
3245,1,1,271,1878,1607
3246,1,1,248,1388,1140
3247,1,0,4,0,-4
3248,0,0,60,0,-60
3249,1,1,312,1632,1320
3250,1,0,100,0,-100
3251,1,1,57,1483,1426
3252,0,0,122,0,-122
3253,0,0,14,0,-14
3254,1,0,78,0,-78
3255,1,1,671,4330,3659
3256,1,0,71,0,-71
3257,1,1,404,1723,1319
3258,0,0,24,0,-24
3259,0,0,20,0,-20
3260,0,0,38,0,-38
3261,1,0,34,0,-34
3262,1,0,0,0,0
3263,1,0,8,0,-8
3264,0,0,16,0,-16
3265,1,1,706,1443,737
3266,1,0,58,0,-58
3267,0,0,12,0,-12
3268,0,0,46,0,-46
3269,1,0,32,0,-32
3270,0,0,52,0,-52
3271,0,0,0,0,0
3272,1,1,168,1762,1594
3273,0,0,86,0,-86
3274,1,0,32,0,-32
3275,0,0,19,0,-19
3276,1,1,239,1618,1379
3277,1,1,88,1543,1455
3278,1,0,17,0,-17
3279,0,0,75,0,-75
3280,0,0,25,0,-25
3281,0,0,39,0,-39
3282,1,0,2,0,-2
3283,1,1,443,1378,935
3284,0,0,20,0,-20
3285,0,0,73,0,-73
3286,0,0,2,0,-2
3287,0,0,10,0,-10
3288,0,0,24,0,-24
3289,1,0,66,0,-66
3290,1,0,118,0,-118
3291,0,0,3,0,-3
3292,1,1,24,2173,2149
3293,1,0,53,0,-53
3294,0,0,17,0,-17
3295,1,0,32,0,-32
3296,1,0,11,0,-11
3297,1,1,462,1471,1009
3298,0,0,205,0,-205
3299,0,0,21,0,-21
3300,0,0,53,0,-53
3301,0,0,188,0,-188
3302,1,1,1312,1536,224
3303,1,1,463,1387,924
3304,1,0,3,0,-3
3305,1,0,88,0,-88
3306,1,1,2531,2172,-359
3307,1,0,10,0,-10
3308,1,0,5,0,-5
3309,1,1,477,1221,744
3310,1,1,252,1577,1325
3311,0,0,5,0,-5
3312,1,0,20,0,-20
3313,1,1,148,1228,1080
3314,1,0,19,0,-19
3315,1,1,463,3406,2943
3316,1,1,164,1387,1223
3317,0,0,9,0,-9
3318,1,0,1,0,-1
3319,1,1,995,1542,547
3320,1,0,66,0,-66
3321,1,1,640,1217,577
3322,0,0,106,0,-106
3323,1,0,156,0,-156
3324,0,0,34,0,-34
3325,0,0,4,0,-4
3326,1,1,664,1544,880
3327,0,0,1,0,-1
3328,1,0,60,0,-60
3329,1,0,42,0,-42
3330,0,0,1,0,-1
3331,0,0,22,0,-22
3332,1,0,84,0,-84
3333,0,0,82,0,-82
3334,1,0,47,0,-47
3335,0,0,4,0,-4
3336,1,1,900,1387,487
3337,1,0,48,0,-48
3338,1,0,8,0,-8
3339,0,0,4,0,-4
3340,1,1,45,1632,1587
3341,1,0,15,0,-15
3342,0,0,63,0,-63
3343,0,0,30,0,-30
3344,0,0,16,0,-16
3345,0,0,21,0,-21
3346,1,1,85,1495,1410
3347,1,0,141,0,-141
3348,1,1,244,2018,1774
3349,1,0,81,0,-81
3350,0,0,87,0,-87
3351,1,0,88,0,-88
3352,1,1,117,1206,1089
3353,1,0,25,0,-25
3354,0,0,57,0,-57
3355,1,0,79,0,-79
3356,1,0,83,0,-83
3357,0,0,28,0,-28
3358,0,0,11,0,-11
3359,1,1,1287,1622,335
3360,0,0,37,0,-37
3361,1,0,7,0,-7
3362,1,0,3,0,-3
3363,1,1,968,1484,516
3364,0,0,5,0,-5
3365,1,1,355,1231,876
3366,0,0,125,0,-125
3367,1,1,66,1490,1424
3368,0,0,8,0,-8
3369,0,0,119,0,-119
3370,1,0,123,0,-123
3371,0,0,119,0,-119
3372,0,0,26,0,-26
3373,0,0,12,0,-12
3374,1,0,24,0,-24
3375,0,0,50,0,-50
3376,0,0,21,0,-21
3377,1,0,12,0,-12
3378,0,0,37,0,-37
3379,0,0,47,0,-47
3380,1,1,354,1825,1471
3381,1,0,33,0,-33
3382,1,1,1078,1278,200
3383,0,0,23,0,-23
3384,1,0,26,0,-26
3385,1,0,31,0,-31
3386,1,1,459,1728,1269
3387,1,0,81,0,-81
3388,1,0,68,0,-68
3389,1,1,627,1264,637
3390,0,0,83,0,-83
3391,1,1,458,1460,1002
3392,1,1,121,1741,1620
3393,0,0,35,0,-35
3394,0,0,36,0,-36
3395,0,0,66,0,-66
3396,0,0,51,0,-51
3397,1,1,265,1387,1122
3398,0,0,3,0,-3
3399,1,1,212,1347,1135
3400,0,0,1,0,-1
3401,0,0,28,0,-28
3402,0,0,157,0,-157
3403,1,1,474,1332,858
3404,0,0,31,0,-31
3405,1,1,688,1866,1178
3406,1,1,70,1551,1481
3407,0,0,81,0,-81
3408,1,0,26,0,-26
3409,1,1,119,1389,1270
3410,0,0,39,0,-39
3411,0,0,14,0,-14
3412,0,0,44,0,-44
3413,1,0,82,0,-82
3414,0,0,25,0,-25
3415,1,1,306,1255,949
3416,1,0,4,0,-4
3417,1,1,556,1236,680
3418,1,0,24,0,-24
3419,0,0,55,0,-55
3420,1,0,47,0,-47
3421,1,0,23,0,-23
3422,1,1,271,1618,1347
3423,1,1,496,2515,2019
3424,1,1,559,1390,831
3425,1,0,56,0,-56
3426,0,0,12,0,-12
3427,1,0,29,0,-29
3428,1,0,34,0,-34
3429,1,0,47,0,-47
3430,1,1,83,1414,1331
3431,1,1,168,1389,1221
3432,0,0,14,0,-14
3433,0,0,6,0,-6
3434,1,1,1192,1257,65
3435,1,0,14,0,-14
3436,1,1,781,1222,441
3437,1,1,361,1248,887
3438,1,0,28,0,-28
3439,1,0,34,0,-34
3440,1,1,78,1952,1874
3441,1,0,11,0,-11
3442,0,0,69,0,-69
3443,0,0,160,0,-160
3444,1,1,646,1362,716
3445,1,1,273,1439,1166
3446,1,1,924,1814,890
3447,1,1,1083,1200,117
3448,1,1,1838,1287,-551
3449,1,1,120,1858,1738
3450,0,0,43,0,-43
3451,0,0,85,0,-85
3452,0,0,4,0,-4
3453,0,0,11,0,-11
3454,0,0,25,0,-25
3455,1,0,19,0,-19
3456,1,0,80,0,-80
3457,0,0,38,0,-38
3458,0,0,50,0,-50
3459,0,0,25,0,-25
3460,1,1,191,1545,1354
3461,0,0,141,0,-141
3462,1,0,3,0,-3
3463,1,1,620,1961,1341
3464,1,1,190,1232,1042
3465,1,1,515,1246,731
3466,0,0,129,0,-129
3467,1,1,199,1609,1410
3468,1,0,120,0,-120
3469,1,1,101,1708,1607
3470,1,1,35,1484,1449
3471,1,0,2,0,-2
3472,0,0,30,0,-30
3473,1,0,144,0,-144
3474,1,1,343,1213,870
3475,0,0,8,0,-8
3476,1,0,87,0,-87
3477,1,1,263,2022,1759
3478,1,1,544,1522,978
3479,0,0,41,0,-41
3480,1,1,248,2232,1984
3481,1,1,2668,1840,-828
3482,0,0,25,0,-25
3483,1,1,387,1362,975
3484,1,0,35,0,-35
3485,0,0,120,0,-120
3486,1,1,509,1258,749
3487,1,1,239,1467,1228
3488,0,0,71,0,-71
3489,1,0,39,0,-39
3490,1,1,767,1323,556
3491,0,0,9,0,-9
3492,1,0,67,0,-67
3493,0,0,24,0,-24
3494,1,0,0,0,0
3495,0,0,24,0,-24
3496,0,0,48,0,-48
3497,1,1,615,1249,634
3498,0,0,28,0,-28
3499,1,1,139,1395,1256
3500,1,0,29,0,-29
3501,1,0,80,0,-80
3502,1,1,131,1477,1346
3503,0,0,42,0,-42
3504,1,1,293,1367,1074
3505,1,0,28,0,-28
3506,1,0,3,0,-3
3507,0,0,59,0,-59
3508,1,1,1531,1416,-115
3509,1,1,329,1716,1387
3510,0,0,51,0,-51
3511,1,1,1055,1705,650
3512,1,1,222,1519,1297
3513,1,1,615,1346,731
3514,1,0,37,0,-37
3515,0,0,68,0,-68
3516,1,0,60,0,-60
3517,1,1,1347,1312,-35
3518,0,0,35,0,-35
3519,1,1,1107,2055,948
3520,1,1,305,1208,903
3521,1,0,34,0,-34
3522,0,0,148,0,-148
3523,1,1,1252,1269,17
3524,1,0,134,0,-134
3525,1,0,13,0,-13
3526,1,0,74,0,-74
3527,1,0,54,0,-54
3528,1,0,46,0,-46
3529,0,0,190,0,-190
3530,1,0,4,0,-4
3531,0,0,2,0,-2
3532,0,0,3,0,-3
3533,0,0,21,0,-21
3534,0,0,168,0,-168
3535,1,0,41,0,-41
3536,0,0,116,0,-116
3537,1,1,784,1525,741
3538,0,0,8,0,-8
3539,1,0,22,0,-22
3540,1,0,53,0,-53
3541,0,0,16,0,-16
3542,1,0,62,0,-62
3543,1,0,37,0,-37
3544,0,0,10,0,-10
3545,0,0,5,0,-5
3546,0,0,28,0,-28
3547,0,0,22,0,-22
3548,0,0,57,0,-57
3549,1,1,214,1660,1446
3550,1,1,638,1285,647
3551,1,1,332,1240,908
3552,0,0,48,0,-48
3553,0,0,81,0,-81
3554,0,0,90,0,-90
3555,0,0,65,0,-65
3556,1,1,1275,2211,936
3557,1,0,84,0,-84
3558,1,1,17,1671,1654
3559,1,0,66,0,-66
3560,1,1,486,1596,1110
3561,0,0,6,0,-6
3562,1,1,161,1917,1756
3563,0,0,8,0,-8
3564,1,0,60,0,-60
3565,1,1,107,1225,1118
3566,0,0,77,0,-77
3567,1,1,282,1256,974
3568,1,0,26,0,-26
3569,1,1,738,1267,529
3570,0,0,11,0,-11
3571,0,0,46,0,-46
3572,1,1,284,1251,967
3573,0,0,53,0,-53
3574,1,0,83,0,-83
3575,1,0,109,0,-109
3576,0,0,31,0,-31
3577,1,0,45,0,-45
3578,1,0,144,0,-144
3579,1,0,5,0,-5
3580,0,0,59,0,-59
3581,1,0,57,0,-57
3582,1,0,77,0,-77
3583,1,1,309,1201,892
3584,1,0,5,0,-5
3585,1,0,29,0,-29
3586,0,0,32,0,-32
3587,1,0,89,0,-89
3588,0,0,74,0,-74
3589,0,0,28,0,-28
3590,1,0,110,0,-110
3591,1,1,557,1256,699
3592,0,0,9,0,-9
3593,1,1,170,1201,1031
3594,0,0,83,0,-83
3595,1,1,117,1602,1485
3596,1,0,8,0,-8
3597,1,1,118,1364,1246
3598,1,0,43,0,-43
3599,1,1,745,1382,637
3600,1,0,4,0,-4
3601,1,1,288,1220,932
3602,0,0,85,0,-85
3603,0,0,145,0,-145
3604,0,0,33,0,-33
3605,1,1,194,1732,1538
3606,0,0,192,0,-192
3607,1,1,1910,1216,-694
3608,1,1,569,1938,1369
3609,1,1,366,1263,897
3610,1,1,534,1414,880
3611,0,0,79,0,-79
3612,1,0,32,0,-32
3613,0,0,74,0,-74
3614,1,0,55,0,-55
3615,1,0,86,0,-86
3616,0,0,38,0,-38
3617,1,0,14,0,-14
3618,1,1,77,1506,1429
3619,0,0,26,0,-26
3620,0,0,1,0,-1
3621,0,0,37,0,-37
3622,0,0,44,0,-44
3623,1,1,380,1248,868
3624,0,0,16,0,-16
3625,0,0,33,0,-33
3626,1,1,469,1510,1041
3627,1,1,1198,1651,453
3628,0,0,9,0,-9
3629,0,0,0,0,0
3630,1,1,412,2633,2221
3631,0,0,45,0,-45
3632,0,0,36,0,-36
3633,1,1,235,2177,1942
3634,0,0,124,0,-124
3635,1,0,39,0,-39
3636,1,1,49,1715,1666
3637,0,0,124,0,-124
3638,1,1,202,1497,1295
3639,0,0,5,0,-5
3640,1,0,47,0,-47
3641,1,0,118,0,-118
3642,0,0,59,0,-59
3643,1,0,4,0,-4
3644,0,0,41,0,-41
3645,0,0,8,0,-8
3646,0,0,129,0,-129
3647,1,1,2303,1417,-886
3648,0,0,12,0,-12
3649,0,0,11,0,-11
3650,0,0,1,0,-1
3651,1,1,777,2911,2134
3652,1,1,1843,1226,-617
3653,1,0,23,0,-23
3654,0,0,28,0,-28
3655,0,0,2,0,-2
3656,0,0,37,0,-37
3657,0,0,18,0,-18
3658,0,0,17,0,-17
3659,1,1,357,2226,1869
3660,0,0,21,0,-21
3661,0,0,12,0,-12
3662,1,1,82,1447,1365
3663,0,0,71,0,-71
3664,1,1,276,1336,1060
3665,0,0,3,0,-3
3666,1,0,33,0,-33
3667,1,0,76,0,-76
3668,0,0,38,0,-38
3669,0,0,8,0,-8
3670,0,0,25,0,-25
3671,0,0,4,0,-4
3672,0,0,78,0,-78
3673,0,0,2,0,-2
3674,1,0,20,0,-20
3675,1,0,1,0,-1
3676,1,1,755,1528,773
3677,0,0,26,0,-26
3678,1,0,41,0,-41
3679,1,1,382,1402,1020
3680,1,1,267,1481,1214
3681,0,0,6,0,-6
3682,0,0,102,0,-102
3683,1,0,19,0,-19
3684,1,1,123,1361,1238
3685,0,0,63,0,-63
3686,0,0,0,0,0
3687,1,0,23,0,-23
3688,1,0,7,0,-7
3689,1,1,624,1455,831
3690,1,0,73,0,-73
3691,0,0,24,0,-24
3692,0,0,177,0,-177
3693,1,1,1155,2504,1349
3694,1,0,11,0,-11
3695,1,1,155,1321,1166
3696,1,1,448,1823,1375
3697,1,0,22,0,-22
3698,1,1,222,1201,979
3699,0,0,2,0,-2
3700,1,1,805,3043,2238
3701,1,1,93,1203,1110
3702,1,1,172,1811,1639
3703,1,1,1162,1357,195
3704,0,0,42,0,-42
3705,1,1,469,1460,991
3706,1,1,273,1349,1076
3707,0,0,20,0,-20
3708,1,1,81,1343,1262
3709,0,0,25,0,-25
3710,1,1,568,1239,671
3711,1,0,42,0,-42
3712,0,0,0,0,0
3713,1,0,37,0,-37
3714,1,1,1320,1231,-89
3715,1,1,430,1369,939
3716,0,0,47,0,-47
3717,1,1,369,1372,1003
3718,1,0,23,0,-23
3719,1,1,995,1203,208
3720,0,0,21,0,-21
3721,1,1,547,1960,1413
3722,0,0,92,0,-92
3723,0,0,57,0,-57
3724,1,0,17,0,-17
3725,1,1,415,1332,917
3726,1,0,60,0,-60
3727,1,0,48,0,-48
3728,1,0,95,0,-95
3729,0,0,27,0,-27
3730,0,0,53,0,-53
3731,1,1,985,1599,614
3732,1,0,6,0,-6
3733,0,0,19,0,-19
3734,0,0,18,0,-18
3735,1,0,38,0,-38
3736,1,1,497,1291,794
3737,1,0,42,0,-42
3738,1,1,2369,1302,-1067
3739,1,0,10,0,-10
3740,1,0,50,0,-50
3741,0,0,40,0,-40
3742,0,0,64,0,-64
3743,0,0,66,0,-66
3744,0,0,54,0,-54
3745,0,0,1,0,-1
3746,0,0,70,0,-70
3747,1,1,314,1291,977
3748,0,0,84,0,-84
3749,1,1,98,1222,1124
3750,1,0,27,0,-27
3751,0,0,51,0,-51
3752,1,0,19,0,-19
3753,1,0,98,0,-98
3754,0,0,78,0,-78
3755,1,1,492,1379,887
3756,1,1,489,1372,883
3757,1,0,40,0,-40
3758,1,0,44,0,-44
3759,1,1,620,1269,649
3760,1,1,2712,1486,-1226
3761,0,0,42,0,-42
3762,1,1,331,1278,947
3763,0,0,9,0,-9
3764,1,1,1703,1690,-13
3765,1,1,39,3402,3363
3766,0,0,17,0,-17
3767,1,1,795,1493,698
3768,0,0,16,0,-16
3769,1,1,34,1267,1233
3770,0,0,69,0,-69
3771,1,0,86,0,-86
3772,1,1,129,2123,1994
3773,0,0,40,0,-40
3774,1,1,87,2032,1945
3775,1,1,135,1578,1443
3776,1,1,260,1325,1065
3777,1,1,64,1291,1227
3778,1,1,702,1697,995
3779,0,0,2,0,-2
3780,0,0,71,0,-71
3781,0,0,50,0,-50
3782,0,0,10,0,-10
3783,1,1,125,1566,1441
3784,1,1,219,1308,1089
3785,1,1,517,1507,990
3786,0,0,135,0,-135
3787,1,0,30,0,-30
3788,1,0,61,0,-61
3789,0,0,83,0,-83
3790,0,0,46,0,-46
3791,1,1,525,2874,2349
3792,0,0,22,0,-22
3793,1,0,66,0,-66
3794,1,1,408,1656,1248
3795,1,1,873,1233,360
3796,1,1,1263,1902,639
3797,1,0,2,0,-2
3798,1,0,85,0,-85
3799,0,0,18,0,-18
3800,0,0,326,0,-326
3801,0,0,43,0,-43
3802,0,0,13,0,-13
3803,0,0,181,0,-181
3804,0,0,85,0,-85
3805,0,0,91,0,-91
3806,0,0,0,0,0
3807,1,1,594,1778,1184
3808,1,1,1780,2677,897
3809,0,0,54,0,-54
3810,0,0,59,0,-59
3811,0,0,20,0,-20
3812,0,0,0,0,0
3813,1,1,92,1233,1141
3814,1,1,50,1229,1179
3815,0,0,11,0,-11
3816,1,0,76,0,-76
3817,1,1,1320,1376,56
3818,0,0,62,0,-62
3819,1,1,137,1492,1355
3820,1,0,16,0,-16
3821,1,1,1330,1702,372
3822,1,1,167,1551,1384
3823,1,0,9,0,-9
3824,1,0,52,0,-52
3825,1,1,201,1380,1179
3826,0,0,61,0,-61
3827,1,0,60,0,-60
3828,0,0,81,0,-81
3829,0,0,12,0,-12
3830,1,1,268,1212,944
3831,1,0,0,0,0
3832,1,0,50,0,-50
3833,1,1,142,1636,1494
3834,0,0,115,0,-115
3835,1,1,664,1326,662
3836,1,0,5,0,-5
3837,1,0,1,0,-1
3838,1,1,616,1367,751
3839,1,0,13,0,-13
3840,1,1,1279,2146,867
3841,1,0,6,0,-6
3842,1,0,50,0,-50
3843,0,0,10,0,-10
3844,1,0,9,0,-9
3845,1,1,928,1539,611
3846,0,0,177,0,-177
3847,1,1,891,2022,1131
3848,0,0,5,0,-5
3849,1,0,5,0,-5
3850,1,1,977,1324,347
3851,0,0,86,0,-86
3852,1,1,484,1348,864
3853,1,0,1,0,-1
3854,1,0,49,0,-49
3855,0,0,7,0,-7
3856,1,1,767,1373,606
3857,1,0,12,0,-12
3858,1,1,599,1843,1244
3859,0,0,51,0,-51
3860,1,1,104,1280,1176
3861,1,0,84,0,-84
3862,1,1,41,1665,1624
3863,1,0,15,0,-15
3864,1,0,28,0,-28
3865,1,1,312,1217,905
3866,1,0,27,0,-27
3867,0,0,19,0,-19
3868,1,0,38,0,-38
3869,1,1,150,1915,1765
3870,1,0,14,0,-14
3871,1,0,8,0,-8
3872,1,0,4,0,-4
3873,1,0,122,0,-122
3874,0,0,24,0,-24
3875,1,1,293,1413,1120
3876,0,0,0,0,0
3877,1,1,114,1297,1183
3878,1,1,878,1389,511
3879,1,0,0,0,0
3880,0,0,13,0,-13
3881,0,0,7,0,-7
3882,1,1,926,1632,706
3883,1,0,9,0,-9
3884,0,0,14,0,-14
3885,0,0,19,0,-19
3886,1,1,49,1321,1272
3887,0,0,4,0,-4
3888,0,0,86,0,-86
3889,0,0,19,0,-19
3890,1,0,74,0,-74
3891,0,0,40,0,-40
3892,1,0,157,0,-157
3893,1,0,71,0,-71
3894,0,0,15,0,-15
3895,0,0,17,0,-17
3896,0,0,12,0,-12
3897,0,0,115,0,-115
3898,1,1,67,1418,1351
3899,0,0,47,0,-47
3900,1,1,919,1282,363
3901,0,0,16,0,-16
3902,0,0,14,0,-14
3903,0,0,24,0,-24
3904,1,1,1478,1865,387
3905,1,1,608,1320,712
3906,1,0,25,0,-25
3907,0,0,53,0,-53
3908,1,0,12,0,-12
3909,1,1,74,1329,1255
3910,1,0,15,0,-15
3911,1,0,98,0,-98
3912,0,0,76,0,-76
3913,1,1,638,4000,3362
3914,0,0,27,0,-27
3915,0,0,12,0,-12
3916,1,1,408,1795,1387
3917,1,0,42,0,-42
3918,0,0,18,0,-18
3919,0,0,33,0,-33
3920,1,1,310,1852,1542
3921,1,0,34,0,-34
3922,1,0,60,0,-60
3923,0,0,83,0,-83
3924,0,0,47,0,-47
3925,0,0,58,0,-58
3926,0,0,42,0,-42
3927,0,0,32,0,-32
3928,0,0,13,0,-13
3929,1,0,16,0,-16
3930,0,0,47,0,-47
3931,1,0,99,0,-99
3932,0,0,58,0,-58
3933,0,0,117,0,-117
3934,1,0,167,0,-167
3935,1,0,15,0,-15
3936,1,1,459,1295,836
3937,1,0,97,0,-97
3938,1,0,50,0,-50
3939,1,1,333,1734,1401
3940,1,1,826,1550,724
3941,1,1,879,1460,581
3942,0,0,34,0,-34
3943,1,0,107,0,-107
3944,1,0,60,0,-60
3945,0,0,0,0,0
3946,1,0,158,0,-158
3947,0,0,12,0,-12
3948,1,0,102,0,-102
3949,1,1,765,1285,520
3950,1,0,51,0,-51
3951,1,1,450,1366,916
3952,1,1,86,1218,1132
3953,1,1,140,1239,1099
3954,0,0,43,0,-43
3955,0,0,9,0,-9
3956,1,0,33,0,-33
3957,0,0,14,0,-14
3958,0,0,47,0,-47
3959,1,1,82,1405,1323
3960,0,0,104,0,-104
3961,1,1,451,2159,1708
3962,1,1,1075,1255,180
3963,1,0,66,0,-66
3964,1,0,3,0,-3
3965,0,0,2,0,-2
3966,0,0,17,0,-17
3967,1,0,4,0,-4
3968,1,1,722,1292,570
3969,1,0,77,0,-77
3970,0,0,44,0,-44
3971,0,0,54,0,-54
3972,0,0,0,0,0
3973,1,0,18,0,-18
3974,1,0,34,0,-34
3975,1,0,206,0,-206
3976,1,0,316,0,-316
3977,1,0,42,0,-42
3978,0,0,378,0,-378
3979,0,0,9,0,-9
3980,1,0,81,0,-81
3981,1,1,81,1220,1139
3982,0,0,105,0,-105
3983,0,0,5,0,-5
3984,1,1,337,1204,867
3985,1,1,655,1783,1128
3986,1,1,216,1692,1476
3987,1,1,2555,1750,-805
3988,0,0,49,0,-49
3989,1,0,111,0,-111
3990,1,1,100,1325,1225
3991,1,0,136,0,-136
3992,0,0,24,0,-24
3993,0,0,108,0,-108
3994,1,1,1244,1672,428
3995,1,1,79,1342,1263
3996,1,0,42,0,-42
3997,1,1,1597,1433,-164
3998,0,0,18,0,-18
3999,0,0,64,0,-64
4000,1,0,124,0,-124
4001,0,0,23,0,-23
4002,1,0,8,0,-8
4003,0,0,12,0,-12
4004,1,0,25,0,-25
4005,0,0,94,0,-94
4006,1,1,1317,1503,186
4007,1,1,1015,1391,376
4008,1,1,327,1241,914
4009,1,1,187,1248,1061
4010,1,0,57,0,-57
4011,0,0,155,0,-155
4012,0,0,15,0,-15
4013,1,0,136,0,-136
4014,1,0,3,0,-3
4015,1,0,16,0,-16
4016,1,0,2,0,-2
4017,0,0,43,0,-43
4018,1,0,31,0,-31
4019,1,1,212,1251,1039
4020,0,0,9,0,-9
4021,0,0,15,0,-15
4022,1,0,32,0,-32
4023,0,0,84,0,-84
4024,1,1,16,2228,2212
4025,0,0,0,0,0
4026,0,0,15,0,-15
4027,1,1,131,1303,1172
4028,0,0,37,0,-37
4029,1,0,150,0,-150
4030,1,0,17,0,-17
4031,0,0,153,0,-153
4032,1,0,21,0,-21
4033,1,1,94,1309,1215
4034,1,1,254,1287,1033
4035,1,1,408,1870,1462
4036,0,0,15,0,-15
4037,1,0,31,0,-31
4038,1,0,107,0,-107
4039,1,1,169,1349,1180
4040,0,0,82,0,-82
4041,1,0,11,0,-11
4042,1,1,210,1552,1342
4043,1,0,41,0,-41
4044,0,0,60,0,-60
4045,1,1,494,1455,961
4046,1,0,162,0,-162
4047,1,0,5,0,-5
4048,1,0,208,0,-208
4049,0,0,14,0,-14
4050,1,0,3,0,-3
4051,1,1,444,1277,833
4052,1,1,415,1574,1159
4053,0,0,11,0,-11
4054,0,0,7,0,-7
4055,0,0,41,0,-41
4056,1,1,1703,1917,214
4057,1,1,774,1396,622
4058,1,1,810,1202,392
4059,1,0,32,0,-32
4060,1,0,37,0,-37
4061,1,1,431,1343,912
4062,0,0,50,0,-50
4063,1,0,6,0,-6
4064,0,0,104,0,-104
4065,0,0,192,0,-192
4066,0,0,37,0,-37
4067,1,0,86,0,-86
4068,0,0,0,0,0
4069,0,0,188,0,-188
4070,1,1,799,1922,1123
4071,1,1,440,1531,1091
4072,1,1,110,1447,1337
4073,0,0,1,0,-1
4074,1,1,292,1434,1142
4075,0,0,4,0,-4
4076,1,1,89,1314,1225
4077,0,0,58,0,-58
4078,1,0,6,0,-6
4079,0,0,47,0,-47
4080,0,0,52,0,-52
4081,0,0,18,0,-18
4082,1,0,47,0,-47
4083,0,0,73,0,-73
4084,0,0,269,0,-269
4085,0,0,27,0,-27
4086,1,0,1,0,-1
4087,0,0,64,0,-64
4088,0,0,110,0,-110
4089,0,0,11,0,-11
4090,0,0,6,0,-6
4091,0,0,11,0,-11
4092,1,0,22,0,-22
4093,0,0,17,0,-17
4094,1,1,317,1266,949
4095,1,1,176,1412,1236
4096,0,0,35,0,-35
4097,0,0,26,0,-26
4098,1,0,6,0,-6
4099,1,1,664,1298,634
4100,0,0,38,0,-38
4101,1,1,34,1733,1699
4102,1,1,392,1524,1132
4103,0,0,23,0,-23
4104,0,0,7,0,-7
4105,0,0,111,0,-111
4106,1,0,128,0,-128
4107,1,0,9,0,-9
4108,0,0,27,0,-27
4109,1,0,64,0,-64
4110,1,0,115,0,-115
4111,1,1,318,1493,1175
4112,1,0,35,0,-35
4113,1,0,17,0,-17
4114,1,1,391,2216,1825
4115,1,0,70,0,-70
4116,1,1,332,1802,1470
4117,1,0,96,0,-96
4118,1,1,145,1298,1153
4119,0,0,20,0,-20
4120,0,0,52,0,-52
4121,1,1,275,2511,2236
4122,0,0,13,0,-13
4123,1,1,426,1338,912
4124,1,1,135,1451,1316
4125,1,0,4,0,-4
4126,0,0,3,0,-3
4127,1,1,387,1601,1214
4128,0,0,78,0,-78
4129,1,0,34,0,-34
4130,0,0,31,0,-31
4131,1,0,66,0,-66
4132,1,0,40,0,-40
4133,1,1,306,1382,1076
4134,1,1,884,1302,418
4135,1,1,225,1401,1176
4136,1,1,1205,1446,241
4137,0,0,1,0,-1
4138,0,0,47,0,-47
4139,1,0,220,0,-220
4140,0,0,42,0,-42
4141,1,0,1,0,-1
4142,1,1,121,1271,1150
4143,0,0,50,0,-50
4144,0,0,17,0,-17
4145,0,0,39,0,-39
4146,0,0,15,0,-15
4147,0,0,41,0,-41
4148,0,0,12,0,-12
4149,0,0,161,0,-161
4150,0,0,25,0,-25
4151,0,0,37,0,-37
4152,0,0,36,0,-36
4153,0,0,98,0,-98
4154,1,1,1239,1488,249
4155,1,1,586,1291,705
4156,1,0,29,0,-29
4157,1,0,44,0,-44
4158,1,1,226,1400,1174
4159,0,0,8,0,-8
4160,1,0,14,0,-14
4161,1,0,17,0,-17
4162,1,0,16,0,-16
4163,0,0,11,0,-11
4164,1,1,167,1712,1545
4165,1,1,940,1483,543
4166,0,0,55,0,-55
4167,1,1,183,1387,1204
4168,0,0,8,0,-8
4169,0,0,14,0,-14
4170,0,0,16,0,-16
4171,0,0,29,0,-29
4172,0,0,18,0,-18
4173,1,1,219,1265,1046
4174,1,0,147,0,-147
4175,0,0,92,0,-92
4176,0,0,76,0,-76
4177,0,0,60,0,-60
4178,1,0,67,0,-67
4179,0,0,18,0,-18
4180,0,0,4,0,-4
4181,1,0,67,0,-67
4182,0,0,3,0,-3
4183,1,1,80,1780,1700
4184,0,0,44,0,-44
4185,0,0,23,0,-23
4186,0,0,15,0,-15
4187,1,1,1156,2121,965
4188,1,1,51,1338,1287
4189,0,0,2,0,-2
4190,0,0,86,0,-86
4191,0,0,14,0,-14
4192,0,0,11,0,-11
4193,1,1,226,1248,1022
4194,0,0,4,0,-4
4195,0,0,50,0,-50
4196,1,1,460,1373,913
4197,1,0,60,0,-60
4198,1,1,70,1439,1369
4199,0,0,10,0,-10
4200,1,1,572,1400,828
4201,1,1,1962,1313,-649
4202,0,0,135,0,-135
4203,1,1,161,1563,1402
4204,1,1,1150,1362,212
4205,1,1,160,1224,1064
4206,0,0,105,0,-105
4207,1,1,513,1428,915
4208,1,1,785,1335,550
4209,1,1,985,2108,1123
4210,1,1,269,2339,2070
4211,1,0,103,0,-103
4212,1,0,8,0,-8
4213,0,0,154,0,-154
4214,0,0,48,0,-48
4215,1,1,547,1245,698
4216,0,0,0,0,0
4217,0,0,184,0,-184
4218,0,0,52,0,-52
4219,1,1,378,1410,1032
4220,0,0,250,0,-250
4221,1,1,152,2123,1971
4222,1,0,36,0,-36
4223,0,0,55,0,-55
4224,0,0,20,0,-20
4225,1,0,0,0,0
4226,1,1,1411,1334,-77
4227,1,1,238,1612,1374
4228,0,0,14,0,-14
4229,1,1,533,1782,1249
4230,1,0,2,0,-2
4231,1,0,12,0,-12
4232,1,0,17,0,-17
4233,0,0,6,0,-6
4234,1,0,75,0,-75
4235,0,0,47,0,-47
4236,0,0,1,0,-1
4237,1,1,120,1779,1659
4238,1,1,243,3586,3343
4239,1,1,270,1301,1031
4240,1,1,563,1316,753
4241,0,0,165,0,-165
4242,1,0,5,0,-5
4243,1,0,0,0,0
4244,0,0,16,0,-16
4245,1,0,75,0,-75
4246,0,0,2,0,-2
4247,1,0,94,0,-94
4248,1,1,117,1313,1196
4249,1,1,131,1373,1242
4250,0,0,47,0,-47
4251,1,1,517,1312,795
4252,0,0,22,0,-22
4253,1,1,686,2127,1441
4254,1,0,111,0,-111
4255,1,0,78,0,-78
4256,1,0,73,0,-73
4257,1,0,28,0,-28
4258,1,0,75,0,-75
4259,1,0,53,0,-53
4260,1,1,1354,1310,-44
4261,1,0,15,0,-15
4262,1,0,23,0,-23
4263,1,0,4,0,-4
4264,0,0,176,0,-176
4265,1,0,31,0,-31
4266,1,0,71,0,-71
4267,0,0,38,0,-38
4268,1,1,239,1403,1164
4269,1,1,2139,1208,-931
4270,1,1,210,1358,1148
4271,1,1,382,1417,1035
4272,0,0,64,0,-64
4273,1,1,252,1496,1244
4274,0,0,143,0,-143
4275,0,0,10,0,-10
4276,0,0,63,0,-63
4277,1,1,4142,1554,-2588
4278,1,1,470,1216,746
4279,1,0,14,0,-14
4280,1,1,631,1298,667
4281,1,1,602,1933,1331
4282,1,1,141,2034,1893
4283,0,0,131,0,-131
4284,1,1,207,1213,1006
4285,1,0,114,0,-114
4286,1,0,100,0,-100
4287,0,0,119,0,-119
4288,1,0,12,0,-12
4289,1,1,452,1277,825
4290,1,1,64,1218,1154
4291,0,0,58,0,-58
4292,1,0,41,0,-41
4293,1,1,161,1410,1249
4294,0,0,119,0,-119
4295,0,0,49,0,-49
4296,1,0,21,0,-21
4297,0,0,18,0,-18
4298,0,0,41,0,-41
4299,1,1,856,1257,401
4300,0,0,100,0,-100
4301,1,0,50,0,-50
4302,1,1,65,1717,1652
4303,0,0,90,0,-90
4304,1,1,367,1366,999
4305,0,0,100,0,-100
4306,0,0,84,0,-84
4307,1,1,653,1483,830
4308,1,0,1,0,-1
4309,0,0,77,0,-77
4310,1,0,91,0,-91
4311,1,0,7,0,-7
4312,0,0,13,0,-13
4313,1,1,585,1366,781
4314,1,1,1251,1263,12
4315,1,0,49,0,-49
4316,1,0,45,0,-45
4317,1,1,67,2158,2091
4318,0,0,81,0,-81
4319,0,0,0,0,0
4320,0,0,100,0,-100
4321,1,1,933,1285,352
4322,1,0,124,0,-124
4323,0,0,31,0,-31
4324,1,0,104,0,-104
4325,1,0,13,0,-13
4326,1,1,624,2584,1960
4327,0,0,16,0,-16
4328,1,1,1335,1384,49
4329,0,0,14,0,-14
4330,0,0,20,0,-20
4331,1,1,1752,1247,-505
4332,1,0,51,0,-51
4333,1,0,2,0,-2
4334,1,1,311,1246,935
4335,0,0,27,0,-27
4336,1,1,1071,2326,1255
4337,1,0,7,0,-7
4338,0,0,8,0,-8
4339,1,0,47,0,-47
4340,1,0,27,0,-27
4341,1,1,733,2269,1536
4342,0,0,45,0,-45
4343,1,1,561,1954,1393
4344,1,1,42,1232,1190
4345,1,0,150,0,-150
4346,0,0,1,0,-1
4347,1,0,43,0,-43
4348,1,1,716,1223,507
4349,1,0,114,0,-114
4350,1,0,0,0,0
4351,0,0,9,0,-9
4352,1,0,6,0,-6
4353,0,0,100,0,-100
4354,1,1,320,2434,2114
4355,1,0,69,0,-69
4356,0,0,50,0,-50
4357,1,0,24,0,-24
4358,1,1,748,1229,481
4359,1,1,350,1210,860
4360,0,0,52,0,-52
4361,1,1,574,1281,707
4362,1,0,94,0,-94
4363,1,0,92,0,-92
4364,1,1,533,1350,817
4365,0,0,108,0,-108
4366,0,0,82,0,-82
4367,1,0,44,0,-44
4368,0,0,68,0,-68
4369,1,1,317,1429,1112
4370,1,1,100,1876,1776
4371,0,0,13,0,-13
4372,0,0,67,0,-67
4373,0,0,60,0,-60
4374,1,1,1073,1397,324
4375,1,0,111,0,-111
4376,1,1,251,1307,1056
4377,0,0,147,0,-147
4378,0,0,73,0,-73
4379,1,0,50,0,-50
4380,1,1,561,1203,642
4381,1,0,26,0,-26
4382,0,0,24,0,-24
4383,0,0,134,0,-134
4384,1,0,64,0,-64
4385,0,0,5,0,-5
4386,0,0,167,0,-167
4387,1,1,992,1201,209
4388,1,1,178,2168,1990
4389,0,0,14,0,-14
4390,1,1,205,1812,1607
4391,0,0,1,0,-1
4392,1,1,764,1215,451
4393,1,1,269,1591,1322
4394,1,0,69,0,-69
4395,1,0,22,0,-22
4396,1,0,237,0,-237
4397,0,0,13,0,-13
4398,0,0,19,0,-19
4399,0,0,126,0,-126
4400,0,0,7,0,-7
4401,1,0,1,0,-1
4402,1,0,9,0,-9
4403,0,0,116,0,-116
4404,1,0,58,0,-58
4405,0,0,31,0,-31
4406,1,0,1,0,-1
4407,0,0,35,0,-35
4408,1,0,61,0,-61
4409,1,0,38,0,-38
4410,1,0,12,0,-12
4411,1,1,72,1590,1518
4412,1,1,739,1612,873
4413,0,0,157,0,-157
4414,1,0,78,0,-78
4415,0,0,0,0,0
4416,1,1,1715,1221,-494
4417,1,1,3438,1376,-2062
4418,0,0,39,0,-39
4419,1,0,12,0,-12
4420,1,0,6,0,-6
4421,1,0,15,0,-15
4422,0,0,57,0,-57
4423,1,0,33,0,-33
4424,1,1,459,1248,789
4425,0,0,58,0,-58
4426,1,0,55,0,-55
4427,1,0,8,0,-8
4428,0,0,2,0,-2
4429,0,0,86,0,-86
4430,1,1,236,1295,1059
4431,0,0,94,0,-94
4432,0,0,57,0,-57
4433,0,0,6,0,-6
4434,1,0,20,0,-20
4435,1,1,805,1463,658
4436,0,0,3,0,-3
4437,1,1,1497,1244,-253
4438,1,0,42,0,-42
4439,1,1,294,1513,1219
4440,1,1,791,3363,2572
4441,1,1,266,1883,1617
4442,0,0,29,0,-29
4443,0,0,21,0,-21
4444,1,0,9,0,-9
4445,1,1,864,1212,348
4446,1,1,766,1304,538
4447,0,0,89,0,-89
4448,0,0,7,0,-7
4449,1,0,14,0,-14
4450,1,0,59,0,-59
4451,1,1,449,1957,1508
4452,1,0,0,0,0
4453,0,0,8,0,-8
4454,1,0,142,0,-142
4455,1,1,539,1388,849
4456,0,0,9,0,-9
4457,1,1,993,1297,304
4458,1,0,9,0,-9
4459,1,1,668,1338,670
4460,1,0,57,0,-57
4461,1,1,106,1204,1098
4462,1,1,87,1231,1144
4463,0,0,200,0,-200
4464,1,0,19,0,-19
4465,1,1,922,1286,364
4466,0,0,21,0,-21
4467,1,0,72,0,-72
4468,1,0,129,0,-129
4469,0,0,16,0,-16
4470,1,1,573,1241,668
4471,1,1,1108,1434,326
4472,0,0,16,0,-16
4473,1,1,64,1260,1196
4474,1,0,48,0,-48
4475,1,1,49,1543,1494
4476,1,0,9,0,-9
4477,1,0,8,0,-8
4478,0,0,74,0,-74
4479,1,0,13,0,-13
4480,1,0,14,0,-14
4481,0,0,79,0,-79
4482,0,0,30,0,-30
4483,0,0,5,0,-5
4484,1,0,11,0,-11
4485,0,0,8,0,-8
4486,0,0,1,0,-1
4487,1,1,2001,1401,-600
4488,0,0,49,0,-49
4489,0,0,20,0,-20
4490,1,1,22,2058,2036
4491,1,0,66,0,-66
4492,1,1,126,1202,1076
4493,1,0,82,0,-82
4494,1,1,182,1219,1037
4495,1,0,31,0,-31
4496,1,1,105,1697,1592
4497,0,0,87,0,-87
4498,0,0,6,0,-6
4499,1,0,20,0,-20
4500,0,0,11,0,-11
4501,0,0,100,0,-100
4502,1,1,561,1421,860
4503,1,0,5,0,-5
4504,0,0,16,0,-16
4505,0,0,43,0,-43
4506,1,0,56,0,-56
4507,0,0,32,0,-32
4508,1,1,417,1280,863
4509,1,1,267,1331,1064
4510,1,0,45,0,-45
4511,1,1,433,1202,769
4512,1,0,40,0,-40
4513,0,0,68,0,-68
4514,1,1,1334,1601,267
4515,0,0,12,0,-12
4516,1,1,1320,1367,47
4517,0,0,15,0,-15
4518,0,0,58,0,-58
4519,1,1,88,5002,4914
4520,1,1,735,1429,694
4521,0,0,1,0,-1
4522,1,0,3,0,-3
4523,1,1,864,1236,372
4524,1,0,15,0,-15
4525,1,0,34,0,-34
4526,1,1,1459,1413,-46
4527,0,0,8,0,-8
4528,1,0,40,0,-40
4529,1,0,86,0,-86
4530,1,1,230,1281,1051
4531,1,0,75,0,-75
4532,1,0,29,0,-29
4533,0,0,40,0,-40
4534,1,0,35,0,-35
4535,0,0,140,0,-140
4536,1,0,33,0,-33
4537,1,0,19,0,-19
4538,1,1,881,6253,5372
4539,0,0,8,0,-8
4540,1,0,70,0,-70
4541,0,0,71,0,-71
4542,1,1,1599,1723,124
4543,0,0,61,0,-61
4544,1,1,557,1449,892
4545,0,0,69,0,-69
4546,1,1,277,1416,1139
4547,0,0,107,0,-107
4548,0,0,24,0,-24
4549,1,1,394,1607,1213
4550,0,0,55,0,-55
4551,0,0,11,0,-11
4552,1,1,416,1245,829
4553,0,0,33,0,-33
4554,1,0,16,0,-16
4555,1,1,183,1514,1331
4556,1,0,287,0,-287
4557,0,0,105,0,-105
4558,0,0,16,0,-16
4559,1,0,72,0,-72
4560,0,0,48,0,-48
4561,0,0,154,0,-154
4562,1,0,37,0,-37
4563,1,1,223,1383,1160
4564,0,0,37,0,-37
4565,0,0,35,0,-35
4566,0,0,25,0,-25
4567,1,0,39,0,-39
4568,1,0,2,0,-2
4569,1,1,1457,2181,724
4570,0,0,12,0,-12
4571,0,0,19,0,-19
4572,1,1,215,1557,1342
4573,0,0,24,0,-24
4574,0,0,15,0,-15
4575,0,0,66,0,-66
4576,0,0,41,0,-41
4577,0,0,13,0,-13
4578,1,0,36,0,-36
4579,0,0,5,0,-5
4580,0,0,17,0,-17
4581,0,0,7,0,-7
4582,0,0,124,0,-124
4583,1,0,14,0,-14
4584,0,0,222,0,-222
4585,1,1,729,1333,604
4586,1,1,571,1341,770
4587,0,0,10,0,-10
4588,0,0,92,0,-92
4589,0,0,57,0,-57
4590,0,0,83,0,-83
4591,1,0,0,0,0
4592,0,0,94,0,-94
4593,0,0,23,0,-23
4594,1,1,462,1246,784
4595,1,1,144,1200,1056
4596,1,0,49,0,-49
4597,0,0,86,0,-86
4598,1,0,166,0,-166
4599,1,0,37,0,-37
4600,1,1,153,1320,1167
4601,0,0,113,0,-113
4602,0,0,59,0,-59
4603,1,0,63,0,-63
4604,1,0,31,0,-31
4605,1,1,590,1299,709
4606,0,0,27,0,-27
4607,0,0,2,0,-2
4608,1,1,1094,2261,1167
4609,1,0,8,0,-8
4610,0,0,3,0,-3
4611,0,0,161,0,-161
4612,0,0,2,0,-2
4613,1,1,432,1530,1098
4614,1,0,111,0,-111
4615,1,1,841,1960,1119
4616,1,0,126,0,-126
4617,1,0,32,0,-32
4618,0,0,10,0,-10
4619,1,1,1865,1433,-432
4620,0,0,29,0,-29
4621,1,0,150,0,-150
4622,1,0,46,0,-46
4623,1,1,168,1276,1108
4624,1,0,92,0,-92
4625,1,0,102,0,-102
4626,1,0,3,0,-3
4627,0,0,6,0,-6
4628,0,0,35,0,-35
4629,1,0,20,0,-20
4630,1,1,62,1533,1471
4631,0,0,5,0,-5
4632,0,0,27,0,-27
4633,1,1,582,1203,621
4634,1,1,243,1362,1119
4635,1,1,1187,1773,586
4636,0,0,94,0,-94
4637,1,0,41,0,-41
4638,1,0,39,0,-39
4639,0,0,4,0,-4
4640,0,0,32,0,-32
4641,0,0,10,0,-10
4642,1,1,336,1297,961
4643,1,1,70,4500,4430
4644,1,1,109,1282,1173
4645,0,0,10,0,-10
4646,0,0,38,0,-38
4647,1,0,144,0,-144
4648,0,0,1,0,-1
4649,0,0,101,0,-101
4650,1,0,48,0,-48
4651,0,0,151,0,-151
4652,0,0,99,0,-99
4653,0,0,18,0,-18
4654,1,1,310,1202,892
4655,0,0,80,0,-80
4656,1,1,303,1425,1122
4657,0,0,49,0,-49
4658,0,0,24,0,-24
4659,1,0,65,0,-65
4660,0,0,4,0,-4
4661,1,0,123,0,-123
4662,1,0,84,0,-84
4663,0,0,21,0,-21
4664,0,0,30,0,-30
4665,0,0,9,0,-9
4666,1,0,145,0,-145
4667,1,1,581,1248,667
4668,0,0,127,0,-127
4669,1,0,19,0,-19
4670,1,0,4,0,-4
4671,1,0,105,0,-105
4672,0,0,12,0,-12
4673,0,0,2,0,-2
4674,1,0,6,0,-6
4675,0,0,49,0,-49
4676,0,0,88,0,-88
4677,1,0,151,0,-151
4678,1,1,180,1229,1049
4679,0,0,119,0,-119
4680,0,0,12,0,-12
4681,1,1,479,1629,1150
4682,1,0,12,0,-12
4683,1,0,8,0,-8
4684,1,0,112,0,-112
4685,1,1,353,1367,1014
4686,0,0,259,0,-259
4687,0,0,17,0,-17
4688,0,0,2,0,-2
4689,0,0,40,0,-40
4690,0,0,0,0,0
4691,0,0,95,0,-95
4692,1,1,234,1429,1195
4693,1,0,75,0,-75
4694,1,0,103,0,-103
4695,0,0,6,0,-6
4696,0,0,6,0,-6
4697,1,0,25,0,-25
4698,1,1,517,1700,1183
4699,1,1,994,2050,1056
4700,1,0,12,0,-12
4701,0,0,11,0,-11
4702,1,0,80,0,-80
4703,0,0,5,0,-5
4704,0,0,52,0,-52
4705,1,1,1614,1964,350
4706,1,0,252,0,-252
4707,0,0,23,0,-23
4708,1,0,26,0,-26
4709,0,0,22,0,-22
4710,1,0,5,0,-5
4711,1,1,677,1383,706
4712,1,1,714,1318,604
4713,0,0,104,0,-104
4714,0,0,7,0,-7
4715,0,0,98,0,-98
4716,1,1,358,1244,886
4717,1,0,127,0,-127
4718,1,1,610,1231,621
4719,1,0,32,0,-32
4720,0,0,118,0,-118
4721,1,1,1108,1266,158
4722,1,1,649,1353,704
4723,1,1,1610,1371,-239
4724,0,0,49,0,-49
4725,0,0,23,0,-23
4726,1,1,190,1593,1403
4727,0,0,4,0,-4
4728,1,1,829,1221,392
4729,1,1,396,1447,1051
4730,1,1,776,2389,1613
4731,1,1,589,1229,640
4732,1,0,18,0,-18
4733,1,0,9,0,-9
4734,1,1,887,1267,380
4735,1,0,69,0,-69
4736,1,0,94,0,-94
4737,1,1,631,1363,732
4738,0,0,18,0,-18
4739,0,0,104,0,-104
4740,0,0,16,0,-16
4741,1,1,907,1205,298
4742,1,0,9,0,-9
4743,0,0,2,0,-2
4744,0,0,1,0,-1
4745,1,0,28,0,-28
4746,1,1,154,1348,1194
4747,1,0,35,0,-35
4748,0,0,45,0,-45
4749,0,0,5,0,-5
4750,1,0,91,0,-91
4751,0,0,66,0,-66
4752,0,0,8,0,-8
4753,0,0,41,0,-41
4754,1,1,428,1205,777
4755,1,1,490,1473,983
4756,1,0,12,0,-12
4757,0,0,51,0,-51
4758,1,1,501,1466,965
4759,1,1,2734,1693,-1041
4760,1,1,115,1358,1243
4761,1,0,13,0,-13
4762,1,0,35,0,-35
4763,0,0,103,0,-103
4764,1,1,988,2052,1064
4765,1,1,305,1694,1389
4766,0,0,55,0,-55
4767,0,0,89,0,-89
4768,0,0,20,0,-20
4769,1,1,991,1612,621
4770,1,0,18,0,-18
4771,0,0,41,0,-41
4772,0,0,288,0,-288
4773,0,0,18,0,-18
4774,1,0,22,0,-22
4775,0,0,1,0,-1
4776,1,1,728,1350,622
4777,1,1,121,1200,1079
4778,1,1,573,1390,817
4779,1,0,37,0,-37
4780,0,0,30,0,-30
4781,1,1,120,1554,1434
4782,0,0,13,0,-13
4783,1,1,1250,1648,398
4784,1,0,3,0,-3
4785,0,0,91,0,-91
4786,0,0,34,0,-34
4787,1,0,48,0,-48
4788,1,0,153,0,-153
4789,0,0,1,0,-1
4790,0,0,128,0,-128
4791,1,1,1283,1331,48
4792,0,0,27,0,-27
4793,0,0,8,0,-8
4794,1,1,258,1235,977
4795,0,0,10,0,-10
4796,1,1,577,1419,842
4797,1,0,5,0,-5
4798,0,0,5,0,-5
4799,1,1,467,1452,985
4800,0,0,86,0,-86
4801,1,0,48,0,-48
4802,0,0,39,0,-39
4803,0,0,74,0,-74
4804,0,0,42,0,-42
4805,0,0,35,0,-35
4806,1,1,242,1582,1340
4807,1,1,1202,1245,43
4808,1,1,1008,1324,316
4809,0,0,17,0,-17
4810,1,1,106,1370,1264
4811,1,1,445,1861,1416
4812,0,0,95,0,-95
4813,0,0,52,0,-52
4814,1,1,150,1567,1417
4815,1,0,84,0,-84
4816,0,0,29,0,-29
4817,0,0,82,0,-82
4818,1,0,3,0,-3
4819,1,0,3,0,-3
4820,1,0,118,0,-118
4821,1,1,1447,1387,-60
4822,1,1,2213,1460,-753
4823,1,1,1035,2101,1066
4824,1,0,7,0,-7
4825,1,1,1047,1224,177
4826,0,0,6,0,-6
4827,0,0,37,0,-37
4828,1,1,134,1819,1685
4829,1,1,406,1711,1305
4830,0,0,28,0,-28
4831,1,1,1834,1726,-108
4832,1,1,2456,1291,-1165
4833,0,0,33,0,-33
4834,1,0,99,0,-99
4835,1,0,0,0,0
4836,1,0,22,0,-22
4837,0,0,190,0,-190
4838,1,1,257,1213,956
4839,0,0,8,0,-8
4840,0,0,80,0,-80
4841,0,0,0,0,0
4842,1,0,4,0,-4
4843,1,1,54,1284,1230
4844,1,0,25,0,-25
4845,0,0,44,0,-44
4846,1,0,89,0,-89
4847,1,1,233,1289,1056
4848,0,0,31,0,-31
4849,1,1,182,2250,2068
4850,0,0,13,0,-13
4851,1,1,813,1415,602
4852,0,0,52,0,-52
4853,0,0,42,0,-42
4854,1,1,4,1456,1452
4855,1,1,230,1547,1317
4856,1,0,2,0,-2
4857,0,0,59,0,-59
4858,0,0,86,0,-86
4859,1,0,319,0,-319
4860,1,0,52,0,-52
4861,0,0,133,0,-133
4862,1,0,48,0,-48
4863,1,0,18,0,-18
4864,0,0,173,0,-173
4865,0,0,50,0,-50
4866,0,0,50,0,-50
4867,1,1,286,1590,1304
4868,1,0,23,0,-23
4869,1,0,77,0,-77
4870,0,0,13,0,-13
4871,1,0,181,0,-181
4872,0,0,173,0,-173
4873,1,0,24,0,-24
4874,1,0,210,0,-210
4875,1,1,822,1453,631
4876,1,1,533,1556,1023
4877,1,0,72,0,-72
4878,1,0,156,0,-156
4879,1,0,95,0,-95
4880,0,0,22,0,-22
4881,1,0,20,0,-20
4882,1,0,25,0,-25
4883,1,1,68,1723,1655
4884,1,0,23,0,-23
4885,1,0,85,0,-85
4886,1,1,326,1330,1004
4887,1,0,13,0,-13
4888,0,0,173,0,-173
4889,0,0,22,0,-22
4890,1,1,305,1284,979
4891,0,0,113,0,-113
4892,0,0,16,0,-16
4893,0,0,49,0,-49
4894,0,0,62,0,-62
4895,1,0,66,0,-66
4896,0,0,43,0,-43
4897,0,0,5,0,-5
4898,1,0,7,0,-7
4899,1,0,90,0,-90
4900,0,0,49,0,-49
4901,1,0,0,0,0
4902,1,0,30,0,-30
4903,0,0,5,0,-5
4904,1,1,57,1269,1212
4905,1,1,536,1551,1015
4906,1,1,164,1252,1088
4907,1,1,123,2050,1927
4908,0,0,8,0,-8
4909,1,1,780,1580,800
4910,1,0,89,0,-89
4911,0,0,145,0,-145
4912,1,0,197,0,-197
4913,1,0,157,0,-157
4914,0,0,89,0,-89
4915,1,1,780,1412,632
4916,1,1,1049,1241,192
4917,0,0,15,0,-15
4918,1,0,28,0,-28
4919,1,1,315,2846,2531
4920,1,1,1209,1890,681
4921,1,1,88,1330,1242
4922,0,0,5,0,-5
4923,1,0,12,0,-12
4924,0,0,225,0,-225
4925,1,1,116,1234,1118
4926,1,0,12,0,-12
4927,1,0,18,0,-18
4928,1,1,297,1510,1213
4929,0,0,14,0,-14
4930,0,0,61,0,-61
4931,0,0,8,0,-8
4932,1,0,126,0,-126
4933,1,1,639,1271,632
4934,1,0,15,0,-15
4935,0,0,44,0,-44
4936,1,1,247,1266,1019
4937,1,0,7,0,-7
4938,0,0,88,0,-88
4939,0,0,35,0,-35
4940,1,1,676,2503,1827
4941,1,1,98,1252,1154
4942,1,0,131,0,-131
4943,0,0,101,0,-101
4944,1,0,6,0,-6
4945,1,0,9,0,-9
4946,1,1,469,1599,1130
4947,1,0,142,0,-142
4948,0,0,234,0,-234
4949,1,0,14,0,-14
4950,0,0,3,0,-3
4951,1,1,316,1407,1091
4952,0,0,43,0,-43
4953,1,1,183,2518,2335
4954,1,1,238,1412,1174
4955,1,1,272,1212,940
4956,0,0,16,0,-16
4957,0,0,53,0,-53
4958,1,1,860,1457,597
4959,1,1,69,1653,1584
4960,0,0,37,0,-37
4961,0,0,98,0,-98
4962,0,0,31,0,-31
4963,1,0,4,0,-4
4964,0,0,68,0,-68
4965,1,1,283,1927,1644
4966,0,0,19,0,-19
4967,0,0,15,0,-15
4968,0,0,28,0,-28
4969,1,0,65,0,-65
4970,1,0,86,0,-86
4971,1,0,0,0,0
4972,0,0,4,0,-4
4973,1,0,2,0,-2
4974,0,0,59,0,-59
4975,0,0,4,0,-4
4976,0,0,12,0,-12
4977,1,0,40,0,-40
4978,0,0,135,0,-135
4979,1,1,428,1235,807
4980,0,0,78,0,-78
4981,1,1,233,1350,1117
4982,0,0,3,0,-3
4983,0,0,51,0,-51
4984,1,1,1327,1273,-54
4985,1,0,26,0,-26
4986,0,0,185,0,-185
4987,1,0,128,0,-128
4988,1,1,184,1856,1672
4989,0,0,32,0,-32
4990,1,0,54,0,-54
4991,1,1,393,1600,1207
4992,0,0,76,0,-76
4993,1,0,423,0,-423
4994,1,0,146,0,-146
4995,1,1,24,1649,1625
4996,1,0,36,0,-36
4997,0,0,17,0,-17
4998,1,0,9,0,-9
4999,1,1,70,1290,1220
5000,1,1,665,1458,793
5001,1,1,1604,1359,-245
5002,1,1,692,1379,687
5003,1,1,862,1237,375
5004,1,0,36,0,-36
5005,0,0,147,0,-147
5006,0,0,123,0,-123
5007,1,0,69,0,-69
5008,1,1,396,1315,919
5009,1,0,15,0,-15
5010,1,1,1460,1285,-175
5011,0,0,60,0,-60
5012,1,1,495,1338,843
5013,1,1,380,1796,1416
5014,1,0,34,0,-34
5015,1,1,317,1267,950
5016,1,1,2974,3431,457
5017,1,1,724,1283,559
5018,1,1,817,2879,2062
5019,0,0,42,0,-42
5020,0,0,2,0,-2
5021,1,1,113,1503,1390
5022,0,0,62,0,-62
5023,0,0,1,0,-1
5024,0,0,12,0,-12
5025,0,0,72,0,-72
5026,1,0,1,0,-1
5027,0,0,28,0,-28
5028,1,1,80,1305,1225
5029,0,0,89,0,-89
5030,1,1,86,1229,1143
5031,0,0,31,0,-31
5032,1,0,0,0,0
5033,1,0,44,0,-44
5034,1,1,526,1324,798
5035,0,0,24,0,-24
5036,1,1,764,1897,1133
5037,0,0,78,0,-78
5038,1,1,984,1779,795
5039,1,1,1473,1473,0
5040,1,0,97,0,-97
5041,1,0,65,0,-65
5042,1,1,647,1230,583
5043,0,0,19,0,-19
5044,1,1,673,1251,578
5045,1,0,83,0,-83
5046,0,0,14,0,-14
5047,0,0,102,0,-102
5048,0,0,109,0,-109
5049,1,0,146,0,-146
5050,0,0,49,0,-49
5051,0,0,70,0,-70
5052,0,0,35,0,-35
5053,1,0,111,0,-111
5054,0,0,25,0,-25
5055,1,1,150,2392,2242
5056,0,0,15,0,-15
5057,1,0,33,0,-33
5058,1,0,142,0,-142
5059,1,0,1,0,-1
5060,0,0,21,0,-21
5061,0,0,103,0,-103
5062,1,0,34,0,-34
5063,0,0,128,0,-128
5064,1,0,18,0,-18
5065,0,0,62,0,-62
5066,1,1,700,1212,512
5067,1,0,162,0,-162
5068,1,1,540,1466,926
5069,1,1,170,1897,1727
5070,0,0,5,0,-5
5071,1,1,75,1434,1359
5072,1,0,11,0,-11
5073,1,1,773,2148,1375
5074,0,0,50,0,-50
5075,1,1,234,1413,1179
5076,1,0,70,0,-70
5077,0,0,76,0,-76
5078,0,0,119,0,-119
5079,1,1,110,1680,1570
5080,0,0,29,0,-29
5081,1,0,70,0,-70
5082,1,0,16,0,-16
5083,0,0,47,0,-47
5084,1,1,997,1830,833
5085,0,0,97,0,-97
5086,1,0,12,0,-12
5087,0,0,222,0,-222
5088,1,1,886,1569,683
5089,0,0,81,0,-81
5090,1,1,210,2275,2065
5091,1,0,28,0,-28
5092,0,0,2,0,-2
5093,0,0,64,0,-64
5094,0,0,125,0,-125
5095,1,1,399,1253,854
5096,1,1,1436,1330,-106
5097,0,0,21,0,-21
5098,1,1,231,1582,1351
5099,1,0,18,0,-18
5100,0,0,257,0,-257
5101,1,1,33,1337,1304
5102,0,0,58,0,-58
5103,1,0,17,0,-17
5104,1,0,67,0,-67
5105,1,1,355,1436,1081
5106,1,1,316,1607,1291
5107,0,0,18,0,-18
5108,0,0,19,0,-19
5109,1,1,371,1417,1046
5110,1,1,430,1296,866
5111,0,0,40,0,-40
5112,1,1,740,2328,1588
5113,1,0,27,0,-27
5114,1,1,157,1327,1170
5115,0,0,72,0,-72
5116,1,0,177,0,-177
5117,1,1,536,2046,1510
5118,0,0,9,0,-9
5119,0,0,35,0,-35
5120,1,1,204,1476,1272
5121,0,0,52,0,-52
5122,1,0,163,0,-163
5123,1,0,2,0,-2
5124,0,0,41,0,-41
5125,1,0,61,0,-61
5126,1,1,268,1539,1271
5127,1,1,369,1273,904
5128,1,1,117,2019,1902
5129,1,1,320,1221,901
5130,1,1,786,1272,486
5131,1,1,382,1490,1108
5132,1,1,22,1209,1187
5133,1,0,21,0,-21
5134,1,0,74,0,-74
5135,1,0,55,0,-55
5136,0,0,26,0,-26
5137,1,0,114,0,-114
5138,1,1,637,1452,815
5139,1,1,684,1633,949
5140,1,1,442,1568,1126
5141,1,1,443,1479,1036
5142,1,1,485,1239,754
5143,1,0,186,0,-186
5144,0,0,73,0,-73
5145,1,1,319,1331,1012
5146,1,1,1091,1290,199
5147,1,1,93,1468,1375
5148,1,0,43,0,-43
5149,1,0,12,0,-12
5150,0,0,3,0,-3
5151,0,0,78,0,-78
5152,1,1,2095,1514,-581
5153,0,0,3,0,-3
5154,0,0,6,0,-6
5155,0,0,15,0,-15
5156,1,1,241,1293,1052
5157,1,0,8,0,-8
5158,1,0,14,0,-14
5159,1,1,1059,1509,450
5160,0,0,35,0,-35
5161,0,0,78,0,-78
5162,0,0,34,0,-34
5163,0,0,19,0,-19
5164,1,1,1020,2123,1103
5165,0,0,14,0,-14
5166,0,0,47,0,-47
5167,0,0,66,0,-66
5168,0,0,0,0,0
5169,1,1,471,1406,935
5170,0,0,45,0,-45
5171,1,0,77,0,-77
5172,1,1,8,1539,1531
5173,0,0,125,0,-125
5174,1,0,21,0,-21
5175,1,1,486,1415,929
5176,0,0,27,0,-27
5177,1,1,492,1555,1063
5178,1,1,1176,1430,254
5179,0,0,43,0,-43
5180,0,0,0,0,0
5181,1,0,17,0,-17
5182,1,1,152,1329,1177
5183,0,0,5,0,-5
5184,1,1,75,1519,1444
5185,1,1,707,1233,526
5186,1,0,99,0,-99
5187,1,1,596,1488,892
5188,1,0,33,0,-33
5189,1,0,115,0,-115
5190,1,0,75,0,-75
5191,1,0,7,0,-7
5192,1,1,293,1219,926
5193,1,1,571,1346,775
5194,0,0,29,0,-29
5195,1,1,565,1511,946
5196,1,0,144,0,-144
5197,1,0,131,0,-131
5198,0,0,95,0,-95
5199,0,0,10,0,-10
5200,1,0,7,0,-7
5201,0,0,9,0,-9
5202,0,0,2,0,-2
5203,1,1,1022,2205,1183
5204,1,1,1092,2042,950
5205,1,1,232,1895,1663
5206,0,0,132,0,-132
5207,0,0,106,0,-106
5208,1,0,0,0,0
5209,1,1,169,1219,1050
5210,1,0,114,0,-114
5211,1,0,209,0,-209
5212,0,0,121,0,-121
5213,1,0,12,0,-12
5214,0,0,18,0,-18
5215,0,0,14,0,-14
5216,1,0,20,0,-20
5217,1,1,178,1202,1024
5218,1,1,2243,1443,-800
5219,1,1,62,2494,2432
5220,0,0,190,0,-190
5221,1,1,460,1528,1068
5222,1,0,41,0,-41
5223,1,1,624,2815,2191
5224,1,0,151,0,-151
5225,0,0,29,0,-29
5226,0,0,99,0,-99
5227,1,0,23,0,-23
5228,1,0,1,0,-1
5229,1,0,30,0,-30
5230,0,0,4,0,-4
5231,0,0,59,0,-59
5232,0,0,19,0,-19
5233,1,1,514,1683,1169
5234,0,0,43,0,-43
5235,1,1,1282,1257,-25
5236,0,0,71,0,-71
5237,0,0,76,0,-76
5238,1,1,538,1379,841
5239,1,0,77,0,-77
5240,1,0,17,0,-17
5241,0,0,124,0,-124
5242,1,0,118,0,-118
5243,1,1,639,1347,708
5244,1,1,97,1721,1624
5245,0,0,91,0,-91
5246,0,0,47,0,-47
5247,0,0,10,0,-10
5248,1,0,11,0,-11
5249,1,1,635,2065,1430
5250,0,0,3,0,-3
5251,1,0,19,0,-19
5252,1,1,109,1467,1358
5253,1,1,495,1656,1161
5254,1,1,740,1626,886
5255,1,0,49,0,-49
5256,0,0,41,0,-41
5257,1,0,0,0,0
5258,1,1,521,1494,973
5259,1,0,100,0,-100
5260,1,1,171,1736,1565
5261,1,1,901,1377,476
5262,0,0,1,0,-1
5263,0,0,2,0,-2
5264,1,0,4,0,-4
5265,1,1,177,1202,1025
5266,1,1,192,1483,1291
5267,1,0,12,0,-12
5268,1,0,93,0,-93
5269,1,0,15,0,-15
5270,1,1,251,1649,1398
5271,1,1,58,1597,1539
5272,1,0,12,0,-12
5273,1,0,0,0,0
5274,1,1,549,1277,728
5275,1,1,484,1660,1176
5276,1,0,6,0,-6
5277,1,1,262,1375,1113
5278,0,0,23,0,-23
5279,1,1,138,1458,1320
5280,1,1,204,2153,1949
5281,0,0,5,0,-5
5282,1,1,658,1400,742
5283,1,0,34,0,-34
5284,1,0,34,0,-34
5285,1,1,683,1265,582
5286,1,0,19,0,-19
5287,0,0,22,0,-22
5288,0,0,33,0,-33
5289,1,1,92,1689,1597
5290,1,1,1143,1564,421
5291,1,1,216,4566,4350
5292,1,1,334,1922,1588
5293,1,0,13,0,-13
5294,1,1,635,1361,726
5295,0,0,66,0,-66
5296,1,0,25,0,-25
5297,0,0,89,0,-89
5298,1,1,259,1383,1124
5299,0,0,14,0,-14
5300,0,0,1,0,-1
5301,0,0,1,0,-1
5302,0,0,35,0,-35
5303,0,0,7,0,-7
5304,0,0,49,0,-49
5305,1,0,16,0,-16
5306,0,0,38,0,-38
5307,0,0,7,0,-7
5308,0,0,8,0,-8
5309,1,0,0,0,0
5310,1,1,81,1242,1161
5311,1,0,45,0,-45
5312,1,0,5,0,-5
5313,1,0,24,0,-24
5314,0,0,15,0,-15
5315,0,0,131,0,-131
5316,1,0,30,0,-30
5317,0,0,194,0,-194
5318,1,0,9,0,-9
5319,1,0,37,0,-37
5320,0,0,69,0,-69
5321,1,1,235,1543,1308
5322,1,0,21,0,-21
5323,0,0,7,0,-7
5324,0,0,49,0,-49
5325,1,1,612,1254,642
5326,0,0,5,0,-5
5327,1,0,56,0,-56
5328,1,1,901,1384,483
5329,0,0,25,0,-25
5330,0,0,143,0,-143
5331,0,0,54,0,-54
5332,1,0,111,0,-111
5333,1,1,635,1420,785
5334,1,0,16,0,-16
5335,1,0,84,0,-84
5336,1,1,421,1209,788
5337,0,0,63,0,-63
5338,0,0,50,0,-50
5339,0,0,18,0,-18
5340,0,0,51,0,-51
5341,0,0,15,0,-15
5342,0,0,1,0,-1
5343,0,0,5,0,-5
5344,0,0,69,0,-69
5345,0,0,71,0,-71
5346,0,0,35,0,-35
5347,1,0,17,0,-17
5348,1,0,120,0,-120
5349,1,1,426,1306,880
5350,1,1,231,1272,1041
5351,1,0,20,0,-20
5352,1,0,101,0,-101
5353,0,0,18,0,-18
5354,0,0,26,0,-26
5355,1,0,53,0,-53
5356,0,0,54,0,-54
5357,1,0,42,0,-42
5358,1,1,744,1228,484
5359,0,0,77,0,-77
5360,0,0,11,0,-11
5361,0,0,0,0,0
5362,1,0,1,0,-1
5363,0,0,26,0,-26
5364,1,0,49,0,-49
5365,0,0,13,0,-13
5366,0,0,11,0,-11
5367,0,0,36,0,-36
5368,1,0,269,0,-269
5369,0,0,49,0,-49
5370,0,0,16,0,-16
5371,1,1,662,2456,1794
5372,0,0,23,0,-23
5373,1,0,9,0,-9
5374,1,1,60,1396,1336
5375,0,0,59,0,-59
5376,0,0,13,0,-13
5377,1,1,114,1378,1264
5378,0,0,12,0,-12
5379,0,0,22,0,-22
5380,1,0,55,0,-55
5381,1,0,22,0,-22
5382,1,1,375,1506,1131
5383,1,1,541,1570,1029
5384,0,0,23,0,-23
5385,1,0,19,0,-19
5386,0,0,11,0,-11
5387,0,0,13,0,-13
5388,0,0,4,0,-4
5389,1,1,226,1407,1181
5390,1,1,583,1371,788
5391,0,0,14,0,-14
5392,1,1,315,1232,917
5393,1,1,401,1447,1046
5394,1,0,357,0,-357
5395,1,1,274,1225,951
5396,0,0,43,0,-43
5397,0,0,34,0,-34
5398,0,0,42,0,-42
5399,0,0,12,0,-12
5400,0,0,57,0,-57
5401,0,0,52,0,-52
5402,1,0,24,0,-24
5403,0,0,16,0,-16
5404,0,0,103,0,-103
5405,0,0,116,0,-116
5406,1,0,52,0,-52
5407,0,0,98,0,-98
5408,0,0,3,0,-3
5409,1,0,23,0,-23
5410,0,0,26,0,-26
5411,0,0,54,0,-54
5412,1,1,163,1490,1327
5413,0,0,115,0,-115
5414,1,1,358,1258,900
5415,1,1,391,1850,1459
5416,1,0,1,0,-1
5417,0,0,6,0,-6
5418,1,0,33,0,-33
5419,1,0,5,0,-5
5420,0,0,34,0,-34
5421,1,0,3,0,-3
5422,0,0,18,0,-18
5423,1,1,52,1282,1230
5424,1,0,17,0,-17
5425,0,0,39,0,-39
5426,0,0,10,0,-10
5427,0,0,24,0,-24
5428,0,0,141,0,-141
5429,1,0,27,0,-27
5430,0,0,52,0,-52
5431,1,0,9,0,-9
5432,0,0,14,0,-14
5433,0,0,32,0,-32
5434,0,0,57,0,-57
5435,0,0,4,0,-4
5436,1,0,76,0,-76
5437,1,1,68,1233,1165
5438,1,1,257,1224,967
5439,0,0,57,0,-57
5440,0,0,199,0,-199
5441,1,1,1282,1414,132
5442,0,0,0,0,0
5443,0,0,235,0,-235
5444,0,0,12,0,-12
5445,0,0,35,0,-35
5446,1,0,14,0,-14
5447,0,0,8,0,-8
5448,0,0,10,0,-10
5449,0,0,1,0,-1
5450,1,1,392,1951,1559
5451,1,0,129,0,-129
5452,1,1,203,1437,1234
5453,0,0,49,0,-49
5454,0,0,25,0,-25
5455,1,1,56,1577,1521
5456,1,0,34,0,-34
5457,0,0,91,0,-91
5458,0,0,86,0,-86
5459,1,1,428,1312,884
5460,1,0,33,0,-33
5461,1,1,440,2711,2271
5462,0,0,14,0,-14
5463,1,0,20,0,-20
5464,1,0,2,0,-2
5465,1,1,106,1249,1143
5466,0,0,6,0,-6
5467,1,0,39,0,-39
5468,1,0,15,0,-15
5469,0,0,51,0,-51
5470,1,0,74,0,-74
5471,1,0,70,0,-70
5472,1,0,114,0,-114
5473,1,0,5,0,-5
5474,0,0,5,0,-5
5475,0,0,50,0,-50
5476,1,1,497,1922,1425
5477,0,0,31,0,-31
5478,0,0,22,0,-22
5479,1,0,5,0,-5
5480,1,1,106,1357,1251
5481,0,0,54,0,-54
5482,1,0,6,0,-6
5483,0,0,116,0,-116
5484,1,1,1769,1405,-364
5485,1,0,107,0,-107
5486,0,0,22,0,-22
5487,1,1,413,1462,1049
5488,0,0,33,0,-33
5489,0,0,4,0,-4
5490,1,0,11,0,-11
5491,1,0,35,0,-35
5492,0,0,28,0,-28
5493,0,0,53,0,-53
5494,1,1,959,1361,402
5495,0,0,32,0,-32
5496,0,0,14,0,-14
5497,1,0,39,0,-39
5498,1,1,724,1431,707
5499,0,0,73,0,-73
5500,1,1,299,1393,1094
5501,0,0,37,0,-37
5502,1,0,118,0,-118
5503,1,1,351,1304,953
5504,0,0,46,0,-46
5505,1,1,42,1271,1229
5506,0,0,33,0,-33
5507,0,0,96,0,-96
5508,1,0,245,0,-245
5509,0,0,215,0,-215
5510,0,0,29,0,-29
5511,0,0,32,0,-32
5512,1,1,1575,1425,-150
5513,1,0,96,0,-96
5514,0,0,20,0,-20
5515,1,0,15,0,-15
5516,1,0,37,0,-37
5517,0,0,296,0,-296
5518,1,1,1780,2028,248
5519,0,0,3,0,-3
5520,0,0,16,0,-16
5521,1,0,62,0,-62
5522,0,0,26,0,-26
5523,0,0,16,0,-16
5524,0,0,4,0,-4
5525,1,0,4,0,-4
5526,1,1,416,1521,1105
5527,1,1,198,1247,1049
5528,0,0,19,0,-19
5529,1,0,90,0,-90
5530,1,1,392,1287,895
5531,1,1,139,1454,1315
5532,1,0,66,0,-66
5533,0,0,47,0,-47
5534,1,0,6,0,-6
5535,1,1,636,1472,836
5536,0,0,55,0,-55
5537,0,0,50,0,-50
5538,1,1,307,1787,1480
5539,1,1,205,1475,1270
5540,1,1,2643,1267,-1376
5541,1,0,93,0,-93
5542,0,0,36,0,-36
5543,0,0,29,0,-29
5544,1,1,297,3440,3143
5545,1,1,28,1579,1551
5546,1,0,21,0,-21
5547,1,1,365,1387,1022
5548,1,1,1200,1300,100
5549,0,0,2,0,-2
5550,1,1,501,1255,754
5551,1,1,518,1436,918
5552,0,0,246,0,-246
5553,1,1,361,1559,1198
5554,0,0,50,0,-50
5555,1,0,19,0,-19
5556,0,0,56,0,-56
5557,0,0,0,0,0
5558,1,0,14,0,-14
5559,1,0,154,0,-154
5560,1,1,224,2413,2189
5561,1,0,14,0,-14
5562,1,1,796,1243,447
5563,0,0,7,0,-7
5564,1,1,422,1246,824
5565,1,0,2,0,-2
5566,1,1,531,1497,966
5567,0,0,125,0,-125
5568,0,0,6,0,-6
5569,0,0,4,0,-4
5570,0,0,26,0,-26
5571,0,0,66,0,-66
5572,0,0,31,0,-31
5573,0,0,19,0,-19
5574,1,0,0,0,0
5575,1,1,1074,1569,495
5576,1,0,5,0,-5
5577,0,0,7,0,-7
5578,1,0,58,0,-58
5579,1,1,716,1974,1258
5580,1,0,15,0,-15
5581,1,1,339,1331,992
5582,1,0,0,0,0
5583,0,0,19,0,-19
5584,0,0,22,0,-22
5585,0,0,3,0,-3
5586,1,1,30,1254,1224
5587,0,0,29,0,-29
5588,1,0,26,0,-26
5589,1,1,2552,1569,-983
5590,1,0,9,0,-9
5591,1,1,112,1361,1249
5592,1,0,56,0,-56
5593,0,0,32,0,-32
5594,0,0,8,0,-8
5595,1,0,84,0,-84
5596,1,1,158,1423,1265
5597,1,0,53,0,-53
5598,0,0,28,0,-28
5599,1,0,8,0,-8
5600,1,0,5,0,-5
5601,0,0,71,0,-71
5602,1,1,332,1247,915
5603,1,1,93,1319,1226
5604,1,1,1549,1905,356
5605,0,0,49,0,-49
5606,0,0,115,0,-115
5607,1,0,86,0,-86
5608,0,0,32,0,-32
5609,0,0,9,0,-9
5610,0,0,82,0,-82
5611,1,1,955,2526,1571
5612,0,0,54,0,-54
5613,0,0,61,0,-61
5614,1,1,231,1205,974
5615,0,0,40,0,-40
5616,0,0,57,0,-57
5617,0,0,16,0,-16
5618,0,0,7,0,-7
5619,1,0,33,0,-33
5620,1,0,29,0,-29
5621,1,0,77,0,-77
5622,0,0,5,0,-5
5623,0,0,81,0,-81
5624,0,0,2,0,-2
5625,1,1,139,1669,1530
5626,1,0,15,0,-15
5627,1,0,24,0,-24
5628,0,0,30,0,-30
5629,0,0,79,0,-79
5630,0,0,34,0,-34
5631,1,0,4,0,-4
5632,0,0,58,0,-58
5633,0,0,34,0,-34
5634,0,0,18,0,-18
5635,0,0,48,0,-48
5636,1,1,477,1269,792
5637,1,0,10,0,-10
5638,1,0,6,0,-6
5639,0,0,2,0,-2
5640,1,1,386,1502,1116
5641,0,0,48,0,-48
5642,0,0,71,0,-71
5643,0,0,61,0,-61
5644,0,0,46,0,-46
5645,0,0,26,0,-26
5646,0,0,59,0,-59
5647,0,0,61,0,-61
5648,1,1,97,1555,1458
5649,1,0,6,0,-6
5650,0,0,12,0,-12
5651,1,0,97,0,-97
5652,1,1,1882,1237,-645
5653,0,0,29,0,-29
5654,0,0,2,0,-2
5655,1,1,383,2041,1658
5656,0,0,6,0,-6
5657,0,0,5,0,-5
5658,0,0,15,0,-15
5659,1,0,98,0,-98
5660,0,0,6,0,-6
5661,0,0,11,0,-11
5662,1,1,94,1428,1334
5663,1,1,936,1817,881
5664,1,0,62,0,-62
5665,1,0,59,0,-59
5666,0,0,83,0,-83
5667,1,1,355,1375,1020
5668,1,0,47,0,-47
5669,1,1,395,1204,809
5670,1,1,442,1204,762
5671,0,0,84,0,-84
5672,0,0,4,0,-4
5673,0,0,33,0,-33
5674,0,0,12,0,-12
5675,1,1,223,1270,1047
5676,0,0,151,0,-151
5677,1,1,153,1886,1733
5678,1,0,196,0,-196
5679,1,1,1073,1307,234
5680,0,0,4,0,-4
5681,1,0,16,0,-16
5682,0,0,51,0,-51
5683,1,0,31,0,-31
5684,0,0,23,0,-23
5685,1,1,1135,2037,902
5686,1,0,2,0,-2
5687,0,0,19,0,-19
5688,1,1,387,2199,1812
5689,0,0,103,0,-103
5690,0,0,17,0,-17
5691,1,0,22,0,-22
5692,1,0,17,0,-17
5693,1,0,5,0,-5
5694,1,0,103,0,-103
5695,0,0,11,0,-11
5696,1,1,157,1711,1554
5697,1,1,375,1776,1401
5698,1,0,7,0,-7
5699,1,0,25,0,-25
5700,1,0,36,0,-36
5701,0,0,35,0,-35
5702,0,0,182,0,-182
5703,1,1,186,1919,1733
5704,1,0,27,0,-27
5705,1,0,22,0,-22
5706,1,1,57,1332,1275
5707,1,1,1719,1375,-344
5708,1,1,205,1417,1212
5709,1,0,0,0,0
5710,0,0,1,0,-1
5711,0,0,15,0,-15
5712,0,0,109,0,-109
5713,0,0,33,0,-33
5714,0,0,10,0,-10
5715,0,0,23,0,-23
5716,1,0,50,0,-50
5717,0,0,9,0,-9
5718,1,1,257,1874,1617
5719,1,1,1560,1933,373
5720,1,0,1,0,-1
5721,0,0,79,0,-79
5722,1,0,37,0,-37
5723,1,0,6,0,-6
5724,1,0,3,0,-3
5725,0,0,37,0,-37
5726,0,0,40,0,-40
5727,0,0,15,0,-15
5728,1,0,145,0,-145
5729,1,1,820,1349,529
5730,1,0,22,0,-22
5731,0,0,20,0,-20
5732,1,1,585,1262,677
5733,0,0,4,0,-4
5734,0,0,2,0,-2
5735,1,0,30,0,-30
5736,0,0,163,0,-163
5737,0,0,79,0,-79
5738,1,1,342,1234,892
5739,0,0,10,0,-10
5740,1,1,972,1490,518
5741,1,1,315,2021,1706
5742,0,0,63,0,-63
5743,1,0,41,0,-41
5744,1,0,19,0,-19
5745,0,0,36,0,-36
5746,1,1,415,1207,792
5747,0,0,45,0,-45
5748,0,0,44,0,-44
5749,0,0,104,0,-104
5750,1,0,66,0,-66
5751,0,0,44,0,-44
5752,1,0,236,0,-236
5753,1,0,9,0,-9
5754,0,0,122,0,-122
5755,1,1,182,1397,1215
5756,1,1,48,2380,2332
5757,1,0,52,0,-52
5758,0,0,102,0,-102
5759,0,0,260,0,-260
5760,1,1,810,1344,534
5761,0,0,39,0,-39
5762,1,1,1273,1226,-47
5763,1,0,6,0,-6
5764,0,0,13,0,-13
5765,1,0,66,0,-66
5766,1,1,909,1494,585
5767,0,0,54,0,-54
5768,0,0,142,0,-142
5769,0,0,35,0,-35
5770,1,0,30,0,-30
5771,1,0,62,0,-62
5772,1,1,726,1685,959
5773,1,1,12,2202,2190
5774,0,0,77,0,-77
5775,0,0,79,0,-79
5776,1,0,109,0,-109
5777,0,0,73,0,-73
5778,1,0,19,0,-19
5779,0,0,43,0,-43
5780,0,0,82,0,-82
5781,1,0,110,0,-110
5782,1,0,13,0,-13
5783,1,1,815,1268,453
5784,0,0,64,0,-64
5785,1,0,33,0,-33
5786,1,1,576,1373,797
5787,1,0,26,0,-26
5788,0,0,112,0,-112
5789,1,0,46,0,-46
5790,1,1,1874,1518,-356
5791,0,0,2,0,-2
5792,1,0,24,0,-24
5793,1,1,1293,2450,1157
5794,1,0,52,0,-52
5795,1,1,293,1521,1228
5796,0,0,38,0,-38
5797,1,0,20,0,-20
5798,0,0,9,0,-9
5799,1,1,653,1291,638
5800,1,0,78,0,-78
5801,1,1,234,1563,1329
5802,1,0,17,0,-17
5803,0,0,52,0,-52
5804,0,0,4,0,-4
5805,0,0,115,0,-115
5806,1,0,78,0,-78
5807,0,0,45,0,-45
5808,1,0,237,0,-237
5809,1,0,13,0,-13
5810,1,1,1501,1521,20
5811,0,0,14,0,-14
5812,1,0,41,0,-41
5813,0,0,6,0,-6
5814,1,1,665,2243,1578
5815,1,1,202,1310,1108
5816,1,0,1,0,-1
5817,0,0,133,0,-133
5818,1,1,709,1258,549
5819,0,0,7,0,-7
5820,1,1,90,1299,1209
5821,1,0,8,0,-8
5822,0,0,10,0,-10
5823,1,0,30,0,-30
5824,0,0,72,0,-72
5825,1,1,1226,1896,670
5826,1,1,2604,1766,-838
5827,0,0,31,0,-31
5828,0,0,236,0,-236
5829,1,0,12,0,-12
5830,0,0,50,0,-50
5831,0,0,0,0,0
5832,1,0,179,0,-179
5833,0,0,12,0,-12
5834,1,1,1160,1379,219
5835,0,0,29,0,-29
5836,0,0,47,0,-47
5837,0,0,95,0,-95
5838,0,0,1,0,-1
5839,1,0,4,0,-4
5840,0,0,46,0,-46
5841,1,1,1894,1288,-606
5842,0,0,34,0,-34
5843,0,0,30,0,-30
5844,1,1,511,1384,873
5845,1,0,4,0,-4
5846,1,0,83,0,-83
5847,1,1,710,1885,1175
5848,0,0,103,0,-103
5849,0,0,7,0,-7
5850,1,1,114,1943,1829
5851,1,1,1497,2136,639
5852,0,0,15,0,-15
5853,1,1,263,1290,1027
5854,0,0,64,0,-64
5855,0,0,38,0,-38
5856,1,1,83,1465,1382
5857,1,1,182,1465,1283
5858,0,0,119,0,-119
5859,1,0,12,0,-12
5860,1,1,195,1380,1185
5861,0,0,9,0,-9
5862,1,0,22,0,-22
5863,1,1,1339,1329,-10
5864,0,0,70,0,-70
5865,0,0,28,0,-28
5866,0,0,123,0,-123
5867,0,0,11,0,-11
5868,1,0,37,0,-37
5869,1,1,765,1238,473
5870,1,0,33,0,-33
5871,1,0,1,0,-1
5872,1,0,20,0,-20
5873,0,0,7,0,-7
5874,1,0,1,0,-1
5875,1,0,4,0,-4
5876,0,0,22,0,-22
5877,0,0,50,0,-50
5878,0,0,42,0,-42
5879,0,0,9,0,-9
5880,1,0,6,0,-6
5881,1,0,38,0,-38
5882,1,0,29,0,-29
5883,1,0,14,0,-14
5884,0,0,16,0,-16
5885,1,0,7,0,-7
5886,0,0,7,0,-7
5887,1,1,670,1228,558
5888,0,0,48,0,-48
5889,0,0,57,0,-57
5890,0,0,61,0,-61
5891,1,0,59,0,-59
5892,1,1,1468,1481,13
5893,1,0,104,0,-104
5894,1,1,1264,1286,22
5895,1,1,1473,1416,-57
5896,0,0,0,0,0
5897,1,0,96,0,-96
5898,1,0,85,0,-85
5899,1,1,705,1898,1193
5900,1,1,112,3708,3596
5901,1,0,59,0,-59
5902,1,0,45,0,-45
5903,1,1,803,1323,520
5904,1,0,60,0,-60
5905,1,1,294,1311,1017
5906,0,0,40,0,-40
5907,0,0,37,0,-37
5908,0,0,19,0,-19
5909,1,0,36,0,-36
5910,0,0,31,0,-31
5911,1,1,85,1254,1169
5912,1,0,52,0,-52
5913,0,0,80,0,-80
5914,1,0,71,0,-71
5915,0,0,93,0,-93
5916,1,1,1271,1987,716
5917,1,0,38,0,-38
5918,1,1,510,1401,891
5919,0,0,43,0,-43
5920,1,1,731,1953,1222
5921,1,1,284,1614,1330
5922,0,0,31,0,-31
5923,1,0,48,0,-48
5924,1,1,428,2277,1849
5925,0,0,136,0,-136
5926,1,0,5,0,-5
5927,0,0,18,0,-18
5928,0,0,17,0,-17
5929,0,0,146,0,-146
5930,0,0,175,0,-175
5931,0,0,13,0,-13
5932,0,0,6,0,-6
5933,1,0,38,0,-38
5934,1,0,55,0,-55
5935,0,0,14,0,-14
5936,0,0,53,0,-53
5937,0,0,26,0,-26
5938,1,1,324,1340,1016
5939,0,0,82,0,-82
5940,0,0,91,0,-91
5941,0,0,46,0,-46
5942,0,0,3,0,-3
5943,1,0,329,0,-329
5944,1,0,11,0,-11
5945,1,1,716,1346,630
5946,1,1,53,2096,2043
5947,1,1,433,1542,1109
5948,1,0,27,0,-27
5949,1,1,691,1246,555
5950,1,1,1359,1990,631
5951,1,0,45,0,-45
5952,0,0,109,0,-109
5953,1,1,332,1357,1025
5954,1,0,17,0,-17
5955,0,0,160,0,-160
5956,0,0,162,0,-162
5957,0,0,63,0,-63
5958,0,0,24,0,-24
5959,0,0,33,0,-33
5960,1,1,179,1213,1034
5961,1,1,1306,1269,-37
5962,1,0,11,0,-11
5963,0,0,8,0,-8
5964,0,0,57,0,-57
5965,1,1,595,1419,824
5966,1,0,20,0,-20
5967,1,1,473,1572,1099
5968,1,0,27,0,-27
5969,0,0,67,0,-67
5970,0,0,3,0,-3
5971,0,0,23,0,-23
5972,1,0,73,0,-73
5973,1,1,532,1287,755
5974,0,0,76,0,-76
5975,1,1,354,1499,1145
5976,1,0,27,0,-27
5977,1,0,133,0,-133
5978,1,0,0,0,0
5979,1,0,27,0,-27
5980,0,0,54,0,-54
5981,0,0,68,0,-68
5982,1,1,1169,1456,287
5983,0,0,37,0,-37
5984,0,0,3,0,-3
5985,1,0,11,0,-11
5986,1,0,253,0,-253
5987,1,0,37,0,-37
5988,1,0,8,0,-8
5989,0,0,32,0,-32
5990,1,0,82,0,-82
5991,0,0,84,0,-84
5992,1,0,125,0,-125
5993,1,1,201,1414,1213
5994,1,1,158,1415,1257
5995,0,0,117,0,-117
5996,1,0,23,0,-23
5997,1,0,6,0,-6
5998,1,1,128,1246,1118
5999,1,0,10,0,-10
6000,0,0,36,0,-36
6001,1,0,70,0,-70
6002,1,0,43,0,-43
6003,1,1,1189,1406,217
6004,1,0,35,0,-35
6005,1,0,57,0,-57
6006,0,0,10,0,-10
6007,1,0,2,0,-2
6008,1,1,955,1391,436
6009,1,1,110,1379,1269
6010,0,0,23,0,-23
6011,0,0,27,0,-27
6012,0,0,5,0,-5
6013,1,1,364,1926,1562
6014,1,0,7,0,-7
6015,1,0,39,0,-39
6016,1,0,57,0,-57
6017,0,0,8,0,-8
6018,0,0,45,0,-45
6019,1,0,25,0,-25
6020,1,0,108,0,-108
6021,1,1,57,1226,1169
6022,1,1,544,1263,719
6023,0,0,77,0,-77
6024,1,1,1196,1200,4
6025,0,0,33,0,-33
6026,0,0,113,0,-113
6027,0,0,16,0,-16
6028,1,0,112,0,-112
6029,1,1,92,1746,1654
6030,1,0,21,0,-21
6031,1,1,165,1493,1328
6032,1,0,3,0,-3
6033,0,0,52,0,-52
6034,1,0,47,0,-47
6035,0,0,20,0,-20
6036,1,0,2,0,-2
6037,1,0,4,0,-4
6038,1,0,4,0,-4
6039,0,0,88,0,-88
6040,1,1,58,1305,1247
6041,0,0,19,0,-19
6042,0,0,1,0,-1
6043,1,0,6,0,-6
6044,1,0,5,0,-5
6045,0,0,75,0,-75
6046,0,0,5,0,-5
6047,1,0,151,0,-151
6048,1,0,3,0,-3
6049,1,0,76,0,-76
6050,1,0,83,0,-83
6051,1,1,964,1954,990
6052,1,1,463,1929,1466
6053,1,1,566,1742,1176
6054,0,0,13,0,-13
6055,0,0,2,0,-2
6056,1,0,91,0,-91
6057,1,1,109,1450,1341
6058,0,0,13,0,-13
6059,1,0,7,0,-7
6060,1,1,990,1744,754
6061,1,0,74,0,-74
6062,0,0,13,0,-13
6063,0,0,59,0,-59
6064,0,0,45,0,-45
6065,1,1,984,2595,1611
6066,0,0,17,0,-17
6067,0,0,142,0,-142
6068,0,0,33,0,-33
6069,0,0,75,0,-75
6070,0,0,39,0,-39
6071,0,0,23,0,-23
6072,0,0,102,0,-102
6073,0,0,60,0,-60
6074,1,1,381,1255,874
6075,1,0,46,0,-46
6076,1,0,24,0,-24
6077,0,0,46,0,-46
6078,0,0,173,0,-173
6079,1,1,68,1325,1257
6080,1,1,1063,1244,181
6081,1,0,74,0,-74
6082,1,1,438,2262,1824
6083,1,1,823,1209,386
6084,0,0,15,0,-15
6085,1,0,15,0,-15
6086,0,0,32,0,-32
6087,1,1,266,1287,1021
6088,1,1,76,1381,1305
6089,0,0,262,0,-262
6090,0,0,67,0,-67
6091,0,0,117,0,-117
6092,1,1,214,1478,1264
6093,1,0,57,0,-57
6094,0,0,0,0,0
6095,0,0,134,0,-134
6096,0,0,193,0,-193
6097,1,0,36,0,-36
6098,0,0,85,0,-85
6099,0,0,102,0,-102
6100,1,0,11,0,-11
6101,1,1,242,2261,2019
6102,1,0,61,0,-61
6103,0,0,3,0,-3
6104,0,0,7,0,-7
6105,0,0,46,0,-46
6106,1,0,68,0,-68
6107,0,0,18,0,-18
6108,0,0,1,0,-1
6109,0,0,7,0,-7
6110,1,1,264,1565,1301
6111,1,1,125,1349,1224
6112,0,0,88,0,-88
6113,0,0,29,0,-29
6114,0,0,92,0,-92
6115,1,1,566,1696,1130
6116,0,0,37,0,-37
6117,1,1,1205,1241,36
6118,1,1,346,1222,876
6119,1,0,168,0,-168
6120,1,0,25,0,-25
6121,0,0,172,0,-172
6122,1,0,264,0,-264
6123,0,0,7,0,-7
6124,1,0,94,0,-94
6125,1,0,54,0,-54
6126,0,0,38,0,-38
6127,0,0,124,0,-124
6128,1,0,48,0,-48
6129,1,1,1177,1779,602
6130,0,0,165,0,-165
6131,0,0,40,0,-40
6132,1,0,81,0,-81
6133,0,0,187,0,-187
6134,1,0,28,0,-28
6135,0,0,98,0,-98
6136,0,0,111,0,-111
6137,0,0,38,0,-38
6138,0,0,12,0,-12
6139,0,0,76,0,-76
6140,0,0,90,0,-90
6141,0,0,0,0,0
6142,1,1,139,1367,1228
6143,1,0,103,0,-103
6144,1,1,501,1213,712
6145,0,0,33,0,-33
6146,0,0,30,0,-30
6147,1,0,242,0,-242
6148,0,0,8,0,-8
6149,1,0,126,0,-126
6150,0,0,35,0,-35
6151,0,0,9,0,-9
6152,0,0,11,0,-11
6153,0,0,45,0,-45
6154,1,0,191,0,-191
6155,0,0,23,0,-23
6156,0,0,17,0,-17
6157,1,1,1401,1561,160
6158,1,1,498,1286,788
6159,1,1,1377,1213,-164
6160,0,0,2,0,-2
6161,1,1,221,1331,1110
6162,0,0,83,0,-83
6163,1,0,24,0,-24
6164,1,0,9,0,-9
6165,0,0,2,0,-2
6166,1,0,19,0,-19
6167,0,0,68,0,-68
6168,1,1,332,1359,1027
6169,0,0,6,0,-6
6170,1,0,11,0,-11
6171,0,0,32,0,-32
6172,0,0,49,0,-49
6173,0,0,8,0,-8
6174,0,0,60,0,-60
6175,0,0,39,0,-39
6176,1,1,855,1291,436
6177,1,0,6,0,-6
6178,1,0,37,0,-37
6179,1,1,22,3033,3011
6180,1,0,34,0,-34
6181,0,0,93,0,-93
6182,0,0,56,0,-56
6183,1,0,143,0,-143
6184,0,0,106,0,-106
6185,1,1,587,1402,815
6186,1,1,370,1201,831
6187,1,0,28,0,-28
6188,0,0,52,0,-52
6189,0,0,64,0,-64
6190,1,1,739,1229,490
6191,0,0,12,0,-12
6192,1,1,508,1346,838
6193,0,0,33,0,-33
6194,1,0,116,0,-116
6195,0,0,16,0,-16
6196,1,1,198,1252,1054
6197,1,1,1743,1315,-428
6198,0,0,4,0,-4
6199,0,0,17,0,-17
6200,1,0,18,0,-18
6201,0,0,16,0,-16
6202,1,1,808,1386,578
6203,0,0,64,0,-64
6204,0,0,65,0,-65
6205,1,0,19,0,-19
6206,0,0,57,0,-57
6207,0,0,24,0,-24
6208,1,1,976,1213,237
6209,0,0,160,0,-160
6210,0,0,44,0,-44
6211,1,1,81,1358,1277
6212,1,0,53,0,-53
6213,1,1,733,1675,942
6214,1,0,65,0,-65
6215,0,0,17,0,-17
6216,0,0,108,0,-108
6217,1,1,821,1605,784
6218,0,0,29,0,-29
6219,1,0,115,0,-115
6220,0,0,61,0,-61
6221,1,0,5,0,-5
6222,1,0,89,0,-89
6223,0,0,17,0,-17
6224,1,1,1415,1780,365
6225,1,0,102,0,-102
6226,1,1,577,1692,1115
6227,1,0,52,0,-52
6228,0,0,24,0,-24
6229,1,0,19,0,-19
6230,1,1,212,2149,1937
6231,1,0,12,0,-12
6232,0,0,4,0,-4
6233,1,0,36,0,-36
6234,1,1,457,2117,1660
6235,0,0,55,0,-55
6236,1,1,836,1805,969
6237,1,0,8,0,-8
6238,1,0,80,0,-80
6239,1,0,10,0,-10
6240,1,0,10,0,-10
6241,0,0,108,0,-108
6242,1,1,173,1265,1092
6243,1,0,4,0,-4
6244,1,0,38,0,-38
6245,1,1,200,1594,1394
6246,1,1,532,1274,742
6247,0,0,9,0,-9
6248,1,0,73,0,-73
6249,1,1,929,1538,609
6250,1,1,734,2145,1411
6251,0,0,11,0,-11
6252,0,0,101,0,-101
6253,1,1,835,1290,455
6254,0,0,121,0,-121
6255,0,0,22,0,-22
6256,0,0,33,0,-33
6257,0,0,39,0,-39
6258,0,0,30,0,-30
6259,1,0,1,0,-1
6260,1,0,24,0,-24
6261,1,1,167,1326,1159
6262,0,0,75,0,-75
6263,1,1,587,2113,1526
6264,1,0,25,0,-25
6265,1,1,871,1462,591
6266,0,0,14,0,-14
6267,0,0,115,0,-115
6268,1,0,9,0,-9
6269,1,0,21,0,-21
6270,1,1,1763,1531,-232
6271,1,0,40,0,-40
6272,0,0,56,0,-56
6273,1,0,154,0,-154
6274,1,1,241,4218,3977
6275,1,1,38,2180,2142
6276,0,0,26,0,-26
6277,0,0,63,0,-63
6278,1,0,135,0,-135
6279,1,0,0,0,0
6280,1,0,97,0,-97
6281,1,1,723,1872,1149
6282,1,0,56,0,-56
6283,0,0,21,0,-21
6284,1,0,54,0,-54
6285,1,0,98,0,-98
6286,0,0,18,0,-18
6287,1,1,172,1409,1237
6288,1,1,987,1300,313
6289,1,0,8,0,-8
6290,0,0,9,0,-9
6291,0,0,12,0,-12
6292,0,0,70,0,-70
6293,1,0,11,0,-11
6294,0,0,13,0,-13
6295,1,1,225,1647,1422
6296,1,0,91,0,-91
6297,1,1,773,1492,719
6298,0,0,59,0,-59
6299,0,0,88,0,-88
6300,0,0,12,0,-12
6301,1,1,256,1545,1289
6302,1,0,22,0,-22
6303,0,0,24,0,-24
6304,0,0,8,0,-8
6305,0,0,14,0,-14
6306,1,0,23,0,-23
6307,1,0,25,0,-25
6308,0,0,0,0,0
6309,0,0,90,0,-90
6310,0,0,44,0,-44
6311,1,0,93,0,-93
6312,1,1,959,1221,262
6313,0,0,11,0,-11
6314,0,0,108,0,-108
6315,0,0,89,0,-89
6316,0,0,55,0,-55
6317,1,0,24,0,-24
6318,0,0,63,0,-63
6319,1,1,107,1791,1684
6320,0,0,37,0,-37
6321,0,0,1,0,-1
6322,0,0,41,0,-41
6323,0,0,1,0,-1
6324,1,1,507,1379,872
6325,1,0,23,0,-23
6326,1,1,717,1207,490
6327,0,0,18,0,-18
6328,0,0,9,0,-9
6329,0,0,29,0,-29
6330,0,0,10,0,-10
6331,1,0,82,0,-82
6332,0,0,68,0,-68
6333,0,0,39,0,-39
6334,1,1,556,1617,1061
6335,0,0,30,0,-30
6336,0,0,15,0,-15
6337,0,0,10,0,-10
6338,0,0,22,0,-22
6339,1,0,41,0,-41
6340,1,0,26,0,-26
6341,1,1,373,1605,1232
6342,1,0,3,0,-3
6343,1,0,75,0,-75
6344,1,1,566,1932,1366
6345,1,1,1902,1217,-685
6346,1,1,782,1319,537
6347,1,1,105,1538,1433
6348,0,0,136,0,-136
6349,1,1,656,1305,649
6350,0,0,102,0,-102
6351,1,0,132,0,-132
6352,0,0,13,0,-13
6353,0,0,25,0,-25
6354,1,0,36,0,-36
6355,0,0,37,0,-37
6356,1,0,141,0,-141
6357,1,0,13,0,-13
6358,1,0,47,0,-47
6359,0,0,77,0,-77
6360,1,1,1277,1240,-37
6361,0,0,99,0,-99
6362,0,0,8,0,-8
6363,1,0,30,0,-30
6364,1,0,16,0,-16
6365,1,0,43,0,-43
6366,1,1,1022,1267,245
6367,1,1,241,1642,1401
6368,1,0,43,0,-43
6369,1,0,1,0,-1
6370,0,0,102,0,-102
6371,0,0,3,0,-3
6372,1,1,423,1568,1145
6373,0,0,15,0,-15
6374,1,1,50,1387,1337
6375,1,0,38,0,-38
6376,1,0,45,0,-45
6377,0,0,34,0,-34
6378,0,0,27,0,-27
6379,1,1,380,1203,823
6380,1,1,302,1555,1253
6381,1,1,1555,1324,-231
6382,0,0,3,0,-3
6383,1,1,1312,1290,-22
6384,0,0,90,0,-90
6385,1,0,7,0,-7
6386,1,0,13,0,-13
6387,1,1,402,1285,883
6388,1,0,14,0,-14
6389,0,0,82,0,-82
6390,0,0,12,0,-12
6391,1,0,34,0,-34
6392,0,0,21,0,-21
6393,1,1,202,1404,1202
6394,1,1,384,1275,891
6395,1,1,404,1634,1230
6396,0,0,32,0,-32
6397,1,1,917,1880,963
6398,1,0,258,0,-258
6399,1,1,184,1223,1039
6400,0,0,80,0,-80
6401,1,0,22,0,-22
6402,0,0,29,0,-29
6403,1,0,90,0,-90
6404,1,0,62,0,-62
6405,0,0,9,0,-9
6406,0,0,15,0,-15
6407,0,0,6,0,-6
6408,1,0,111,0,-111
6409,0,0,30,0,-30
6410,1,1,1055,1290,235
6411,1,1,2491,1331,-1160
6412,1,1,278,1551,1273
6413,0,0,22,0,-22
6414,0,0,61,0,-61
6415,1,0,18,0,-18
6416,0,0,120,0,-120
6417,0,0,0,0,0
6418,1,1,599,1247,648
6419,0,0,5,0,-5
6420,0,0,142,0,-142
6421,1,0,3,0,-3
6422,1,1,1410,1497,87
6423,1,0,36,0,-36
6424,1,1,1400,2566,1166
6425,0,0,3,0,-3
6426,0,0,109,0,-109
6427,1,1,280,1449,1169
6428,1,0,43,0,-43
6429,0,0,88,0,-88
6430,1,0,5,0,-5
6431,0,0,18,0,-18
6432,0,0,26,0,-26
6433,0,0,8,0,-8
6434,1,1,515,1528,1013
6435,1,0,64,0,-64
6436,1,0,20,0,-20
6437,1,1,297,1300,1003
6438,0,0,79,0,-79
6439,1,0,150,0,-150
6440,1,1,307,1248,941
6441,1,0,8,0,-8
6442,1,1,467,1238,771
6443,1,1,517,1384,867
6444,1,1,134,1362,1228
6445,0,0,102,0,-102
6446,1,0,40,0,-40
6447,0,0,52,0,-52
6448,0,0,213,0,-213
6449,0,0,26,0,-26
6450,1,1,178,1237,1059
6451,1,0,0,0,0
6452,0,0,160,0,-160
6453,0,0,55,0,-55
6454,1,1,174,1642,1468
6455,0,0,85,0,-85
6456,0,0,68,0,-68
6457,1,0,45,0,-45
6458,1,1,25,1232,1207
6459,1,1,151,1225,1074
6460,1,0,53,0,-53
6461,0,0,195,0,-195
6462,0,0,39,0,-39
6463,1,0,16,0,-16
6464,0,0,69,0,-69
6465,1,1,265,1855,1590
6466,0,0,16,0,-16
6467,1,1,625,1621,996
6468,1,1,1056,1261,205
6469,0,0,0,0,0
6470,0,0,32,0,-32
6471,1,1,155,1243,1088
6472,0,0,10,0,-10
6473,1,1,100,1466,1366
6474,1,1,1413,1902,489
6475,1,0,4,0,-4
6476,1,0,27,0,-27
6477,1,0,71,0,-71
6478,0,0,34,0,-34
6479,1,0,48,0,-48
6480,1,0,92,0,-92
6481,1,0,6,0,-6
6482,0,0,38,0,-38
6483,0,0,28,0,-28
6484,1,1,1098,1984,886
6485,1,0,185,0,-185
6486,1,1,806,1756,950
6487,1,1,333,1468,1135
6488,1,0,228,0,-228
6489,0,0,3,0,-3
6490,1,1,1288,1651,363
6491,0,0,51,0,-51
6492,0,0,45,0,-45
6493,0,0,0,0,0
6494,0,0,57,0,-57
6495,0,0,19,0,-19
6496,1,0,38,0,-38
6497,0,0,88,0,-88
6498,0,0,208,0,-208
6499,1,0,11,0,-11
6500,0,0,42,0,-42
6501,1,0,19,0,-19
6502,0,0,82,0,-82
6503,1,1,963,1247,284
6504,1,0,217,0,-217
6505,1,1,106,2866,2760
6506,0,0,30,0,-30
6507,1,0,7,0,-7
6508,1,1,127,1428,1301
6509,1,0,29,0,-29
6510,0,0,89,0,-89
6511,0,0,19,0,-19
6512,1,1,431,1227,796
6513,1,0,27,0,-27
6514,1,0,15,0,-15
6515,0,0,11,0,-11
6516,1,0,79,0,-79
6517,0,0,6,0,-6
6518,0,0,40,0,-40
6519,0,0,18,0,-18
6520,1,0,19,0,-19
6521,1,1,119,1339,1220
6522,0,0,68,0,-68
6523,1,1,160,2068,1908
6524,1,0,1,0,-1
6525,1,1,140,1538,1398
6526,1,1,1086,1561,475
6527,1,0,25,0,-25
6528,1,1,1183,1771,588
6529,0,0,6,0,-6
6530,0,0,39,0,-39
6531,0,0,151,0,-151
6532,1,1,233,1287,1054
6533,1,0,58,0,-58
6534,1,1,1642,1254,-388
6535,1,1,245,1452,1207
6536,1,1,13,1360,1347
6537,0,0,36,0,-36
6538,1,1,331,1960,1629
6539,1,1,1203,1216,13
6540,0,0,43,0,-43
6541,0,0,0,0,0
6542,1,1,88,1563,1475
6543,1,1,180,1566,1386
6544,0,0,82,0,-82
6545,1,0,147,0,-147
6546,0,0,15,0,-15
6547,0,0,106,0,-106
6548,1,0,12,0,-12
6549,1,1,460,1382,922
6550,1,1,907,1555,648
6551,0,0,37,0,-37
6552,1,1,151,1276,1125
6553,0,0,63,0,-63
6554,1,0,167,0,-167
6555,1,1,890,1322,432
6556,0,0,34,0,-34
6557,1,0,80,0,-80
6558,1,0,2,0,-2
6559,1,1,263,1590,1327
6560,0,0,63,0,-63
6561,0,0,15,0,-15
6562,0,0,83,0,-83
6563,1,1,636,1314,678
6564,1,0,22,0,-22
6565,1,0,38,0,-38
6566,1,1,312,1933,1621
6567,0,0,5,0,-5
6568,0,0,75,0,-75
6569,0,0,55,0,-55
6570,1,0,19,0,-19
6571,1,0,6,0,-6
6572,0,0,49,0,-49
6573,1,0,118,0,-118
6574,1,1,214,1356,1142
6575,1,1,438,1370,932
6576,0,0,12,0,-12
6577,0,0,69,0,-69
6578,1,1,2396,1246,-1150
6579,1,1,45,1361,1316
6580,1,0,7,0,-7
6581,0,0,55,0,-55
6582,0,0,248,0,-248
6583,0,0,29,0,-29
6584,0,0,6,0,-6
6585,1,1,403,1237,834
6586,0,0,135,0,-135
6587,1,0,10,0,-10
6588,0,0,5,0,-5
6589,1,0,12,0,-12
6590,1,0,42,0,-42
6591,1,0,40,0,-40
6592,0,0,29,0,-29
6593,1,1,13,1551,1538
6594,0,0,3,0,-3
6595,0,0,2,0,-2
6596,1,1,513,2386,1873
6597,1,1,128,1297,1169
6598,0,0,7,0,-7
6599,1,0,32,0,-32
6600,1,0,10,0,-10
6601,1,1,130,1478,1348
6602,1,0,28,0,-28
6603,0,0,29,0,-29
6604,0,0,97,0,-97
6605,0,0,33,0,-33
6606,1,0,146,0,-146
6607,0,0,32,0,-32
6608,1,0,101,0,-101
6609,1,0,45,0,-45
6610,0,0,56,0,-56
6611,0,0,24,0,-24
6612,0,0,50,0,-50
6613,1,1,160,1390,1230
6614,1,1,182,1246,1064
6615,1,0,6,0,-6
6616,1,0,55,0,-55
6617,1,1,573,1862,1289
6618,1,1,186,1712,1526
6619,1,0,0,0,0
6620,1,0,22,0,-22
6621,0,0,18,0,-18
6622,1,1,610,1711,1101
6623,0,0,20,0,-20
6624,0,0,65,0,-65
6625,0,0,98,0,-98
6626,0,0,64,0,-64
6627,1,1,217,2557,2340
6628,0,0,49,0,-49
6629,0,0,5,0,-5
6630,0,0,47,0,-47
6631,0,0,116,0,-116
6632,1,1,524,1208,684
6633,0,0,231,0,-231
6634,1,0,101,0,-101
6635,1,0,28,0,-28
6636,0,0,123,0,-123
6637,0,0,93,0,-93
6638,1,1,241,2683,2442
6639,0,0,124,0,-124
6640,1,1,381,1461,1080
6641,1,0,52,0,-52
6642,1,0,21,0,-21
6643,1,1,5,1219,1214
6644,0,0,41,0,-41
6645,0,0,73,0,-73
6646,0,0,35,0,-35
6647,0,0,27,0,-27
6648,1,1,367,1694,1327
6649,1,1,257,1236,979
6650,1,1,390,1211,821
6651,1,1,288,1390,1102
6652,1,0,33,0,-33
6653,0,0,7,0,-7
6654,0,0,24,0,-24
6655,1,1,150,1432,1282
6656,0,0,18,0,-18
6657,0,0,36,0,-36
6658,0,0,88,0,-88
6659,0,0,25,0,-25
6660,1,1,140,1308,1168
6661,1,1,91,1338,1247
6662,1,0,59,0,-59
6663,0,0,8,0,-8
6664,0,0,135,0,-135
6665,1,1,763,1455,692
6666,0,0,143,0,-143
6667,0,0,122,0,-122
6668,0,0,6,0,-6
6669,1,0,32,0,-32
6670,1,1,1250,1367,117
6671,1,1,305,1482,1177
6672,0,0,74,0,-74
6673,1,0,23,0,-23
6674,0,0,70,0,-70
6675,1,1,319,3491,3172
6676,0,0,126,0,-126
6677,0,0,89,0,-89
6678,1,0,56,0,-56
6679,1,0,32,0,-32
6680,1,1,1222,1972,750
6681,0,0,34,0,-34
6682,1,0,85,0,-85
6683,1,0,24,0,-24
6684,0,0,35,0,-35
6685,0,0,96,0,-96
6686,1,1,870,1496,626
6687,1,0,12,0,-12
6688,1,0,7,0,-7
6689,0,0,13,0,-13
6690,0,0,56,0,-56
6691,1,1,275,1506,1231
6692,0,0,17,0,-17
6693,0,0,23,0,-23
6694,1,0,44,0,-44
6695,1,0,20,0,-20
6696,1,0,40,0,-40
6697,1,1,1554,1284,-270
6698,0,0,360,0,-360
6699,0,0,122,0,-122
6700,1,1,406,1242,836
6701,0,0,17,0,-17
6702,0,0,71,0,-71
6703,1,1,668,1363,695
6704,0,0,42,0,-42
6705,0,0,14,0,-14
6706,0,0,13,0,-13
6707,0,0,14,0,-14
6708,1,1,320,1558,1238
6709,1,1,522,1524,1002
6710,1,1,606,1675,1069
6711,1,0,3,0,-3
6712,0,0,52,0,-52
6713,1,0,4,0,-4
6714,1,1,142,1224,1082
6715,1,1,567,1272,705
6716,0,0,43,0,-43
6717,1,1,971,1212,241
6718,1,0,178,0,-178
6719,1,0,45,0,-45
6720,0,0,44,0,-44
6721,1,0,53,0,-53
6722,1,0,43,0,-43
6723,0,0,90,0,-90
6724,0,0,148,0,-148
6725,1,1,65,1394,1329
6726,0,0,67,0,-67
6727,1,1,1276,1369,93
6728,0,0,25,0,-25
6729,1,0,128,0,-128
6730,1,1,644,2003,1359
6731,0,0,0,0,0
6732,1,1,652,1516,864
6733,1,0,136,0,-136
6734,1,1,91,1462,1371
6735,1,1,531,1428,897
6736,1,0,2,0,-2
6737,0,0,23,0,-23
6738,1,1,355,1770,1415
6739,1,0,24,0,-24
6740,1,1,166,1212,1046
6741,0,0,0,0,0
6742,1,0,39,0,-39
6743,0,0,8,0,-8
6744,0,0,121,0,-121
6745,0,0,80,0,-80
6746,0,0,41,0,-41
6747,1,0,75,0,-75
6748,1,0,29,0,-29
6749,0,0,38,0,-38
6750,0,0,128,0,-128
6751,0,0,63,0,-63
6752,0,0,28,0,-28
6753,1,0,49,0,-49
6754,1,1,182,1713,1531
6755,0,0,31,0,-31
6756,1,1,1215,1275,60
6757,1,1,476,1280,804
6758,1,1,153,1525,1372
6759,1,1,353,1684,1331
6760,1,0,29,0,-29
6761,1,1,324,1436,1112
6762,1,1,766,4981,4215
6763,1,0,30,0,-30
6764,1,1,138,1501,1363
6765,1,0,22,0,-22
6766,0,0,2,0,-2
6767,1,1,723,1497,774
6768,0,0,59,0,-59
6769,1,1,472,1331,859
6770,0,0,12,0,-12
6771,0,0,41,0,-41
6772,0,0,40,0,-40
6773,0,0,14,0,-14
6774,1,0,19,0,-19
6775,1,1,213,3845,3632
6776,0,0,16,0,-16
6777,1,0,196,0,-196
6778,1,0,14,0,-14
6779,0,0,27,0,-27
6780,1,0,15,0,-15
6781,1,0,116,0,-116
6782,0,0,21,0,-21
6783,1,0,2,0,-2
6784,0,0,92,0,-92
6785,1,0,42,0,-42
6786,1,1,143,1616,1473
6787,1,0,2,0,-2
6788,0,0,14,0,-14
6789,1,0,30,0,-30
6790,0,0,76,0,-76
6791,0,0,26,0,-26
6792,1,0,10,0,-10
6793,1,1,220,1238,1018
6794,1,0,67,0,-67
6795,0,0,22,0,-22
6796,0,0,9,0,-9
6797,0,0,21,0,-21
6798,1,0,23,0,-23
6799,1,0,20,0,-20
6800,1,1,1011,1350,339
6801,0,0,49,0,-49
6802,1,0,14,0,-14
6803,0,0,9,0,-9
6804,1,0,3,0,-3
6805,0,0,5,0,-5
6806,0,0,13,0,-13
6807,1,0,96,0,-96
6808,0,0,8,0,-8
6809,0,0,102,0,-102
6810,0,0,18,0,-18
6811,1,1,547,1274,727
6812,0,0,86,0,-86
6813,1,0,53,0,-53
6814,1,0,7,0,-7
6815,0,0,38,0,-38
6816,0,0,53,0,-53
6817,1,1,574,2540,1966
6818,1,0,6,0,-6
6819,1,1,292,1298,1006
6820,1,1,1334,1686,352
6821,0,0,16,0,-16
6822,0,0,6,0,-6
6823,0,0,67,0,-67
6824,0,0,45,0,-45
6825,1,0,30,0,-30
6826,1,0,25,0,-25
6827,1,1,648,1691,1043
6828,1,0,63,0,-63
6829,0,0,30,0,-30
6830,1,0,16,0,-16
6831,0,0,7,0,-7
6832,0,0,62,0,-62
6833,0,0,38,0,-38
6834,0,0,30,0,-30
6835,1,1,595,2219,1624
6836,1,0,5,0,-5
6837,1,1,153,1319,1166
6838,1,1,1117,1261,144
6839,1,1,12,1392,1380
6840,1,0,23,0,-23
6841,1,0,8,0,-8
6842,1,0,15,0,-15
6843,1,0,22,0,-22
6844,1,1,969,1921,952
6845,0,0,1,0,-1
6846,1,1,398,1349,951
6847,1,1,599,1214,615
6848,0,0,4,0,-4
6849,0,0,40,0,-40
6850,1,1,234,1649,1415
6851,1,1,78,1838,1760
6852,1,0,70,0,-70
6853,1,0,2,0,-2
6854,0,0,143,0,-143
6855,1,1,1128,1507,379
6856,0,0,6,0,-6
6857,0,0,171,0,-171
6858,1,0,34,0,-34
6859,1,1,713,1361,648
6860,1,0,77,0,-77
6861,1,1,74,1402,1328
6862,0,0,9,0,-9
6863,1,1,592,1267,675
6864,1,0,238,0,-238
6865,0,0,9,0,-9
6866,1,0,9,0,-9
6867,1,0,14,0,-14
6868,0,0,68,0,-68
6869,1,1,341,2450,2109
6870,1,0,11,0,-11
6871,1,1,121,2055,1934
6872,1,0,1,0,-1
6873,1,0,37,0,-37
6874,0,0,9,0,-9
6875,0,0,44,0,-44
6876,1,1,196,1840,1644
6877,1,1,1114,2309,1195
6878,0,0,1,0,-1
6879,1,1,755,1283,528
6880,1,0,16,0,-16
6881,1,1,96,1492,1396
6882,1,0,120,0,-120
6883,0,0,43,0,-43
6884,1,0,80,0,-80
6885,1,0,8,0,-8
6886,0,0,98,0,-98
6887,1,0,84,0,-84
6888,0,0,40,0,-40
6889,0,0,4,0,-4
6890,1,0,57,0,-57
6891,1,1,375,1795,1420
6892,1,1,2536,1457,-1079
6893,1,1,11,1248,1237
6894,1,0,61,0,-61
6895,1,0,47,0,-47
6896,1,0,48,0,-48
6897,1,1,192,1549,1357
6898,1,1,418,1311,893
6899,1,0,28,0,-28
6900,1,1,105,1736,1631
6901,1,0,9,0,-9
6902,1,0,40,0,-40
6903,0,0,8,0,-8
6904,1,1,318,1648,1330
6905,1,0,80,0,-80
6906,1,1,491,1806,1315
6907,1,0,46,0,-46
6908,0,0,79,0,-79
6909,1,1,1093,1549,456
6910,1,0,124,0,-124
6911,0,0,35,0,-35
6912,1,0,12,0,-12
6913,1,1,577,1291,714
6914,1,0,141,0,-141
6915,1,0,85,0,-85
6916,0,0,79,0,-79
6917,1,1,50,1474,1424
6918,1,0,36,0,-36
6919,1,0,130,0,-130
6920,0,0,89,0,-89
6921,1,1,342,1463,1121
6922,1,1,1022,1280,258
6923,1,1,206,3914,3708
6924,1,1,71,1368,1297
6925,1,0,65,0,-65
6926,1,0,166,0,-166
6927,1,1,555,1234,679
6928,1,0,51,0,-51
6929,1,1,247,2119,1872
6930,1,0,115,0,-115
6931,0,0,55,0,-55
6932,1,1,218,1316,1098
6933,1,1,558,1884,1326
6934,1,0,98,0,-98
6935,0,0,25,0,-25
6936,1,0,2,0,-2
6937,1,0,32,0,-32
6938,1,0,68,0,-68
6939,1,0,5,0,-5
6940,1,1,1943,1640,-303
6941,1,1,28,1291,1263
6942,1,1,146,1229,1083
6943,1,0,21,0,-21
6944,1,0,89,0,-89
6945,0,0,73,0,-73
6946,0,0,23,0,-23
6947,1,0,38,0,-38
6948,1,0,49,0,-49
6949,1,0,4,0,-4
6950,1,0,28,0,-28
6951,1,1,320,1481,1161
6952,0,0,25,0,-25
6953,0,0,46,0,-46
6954,1,1,90,1221,1131
6955,1,1,1103,1335,232
6956,1,0,81,0,-81
6957,0,0,46,0,-46
6958,1,1,184,1525,1341
6959,1,1,832,1202,370
6960,1,1,1694,1348,-346
6961,1,1,219,1901,1682
6962,1,0,43,0,-43
6963,1,1,80,1847,1767
6964,1,1,137,1397,1260
6965,0,0,13,0,-13
6966,1,0,15,0,-15
6967,1,0,53,0,-53
6968,1,1,638,1341,703
6969,1,1,58,1306,1248
6970,1,0,0,0,0
6971,0,0,60,0,-60
6972,1,1,731,1737,1006
6973,1,0,30,0,-30
6974,1,0,12,0,-12
6975,1,0,0,0,0
6976,0,0,98,0,-98
6977,1,1,173,1305,1132
6978,1,0,23,0,-23
6979,1,0,100,0,-100
6980,0,0,186,0,-186
6981,0,0,27,0,-27
6982,1,0,0,0,0
6983,1,0,196,0,-196
6984,1,1,127,1463,1336
6985,1,0,6,0,-6
6986,0,0,39,0,-39
6987,1,1,327,1592,1265
6988,0,0,19,0,-19
6989,1,0,14,0,-14
6990,1,0,10,0,-10
6991,1,0,17,0,-17
6992,0,0,0,0,0
6993,0,0,134,0,-134
6994,1,0,156,0,-156
6995,1,1,883,1328,445
6996,1,0,10,0,-10
6997,1,1,152,1490,1338
6998,1,0,30,0,-30
6999,1,1,539,1840,1301
7000,1,0,26,0,-26
7001,1,1,290,1440,1150
7002,0,0,17,0,-17
7003,1,0,25,0,-25
7004,1,1,509,2848,2339
7005,1,0,40,0,-40
7006,0,0,2,0,-2
7007,1,1,95,1328,1233
7008,0,0,38,0,-38
7009,0,0,53,0,-53
7010,1,0,16,0,-16
7011,1,0,0,0,0
7012,0,0,53,0,-53
7013,1,1,825,1444,619
7014,1,1,332,1637,1305
7015,1,0,44,0,-44
7016,1,0,8,0,-8
7017,1,1,499,1518,1019
7018,1,0,13,0,-13
7019,1,1,16,1362,1346
7020,1,0,11,0,-11
7021,1,0,103,0,-103
7022,1,1,1486,1536,50
7023,1,0,75,0,-75
7024,0,0,6,0,-6
7025,0,0,160,0,-160
7026,1,1,996,1242,246
7027,0,0,22,0,-22
7028,1,1,339,1331,992
7029,0,0,6,0,-6
7030,1,1,692,1332,640
7031,1,1,1559,1706,147
7032,0,0,13,0,-13
7033,0,0,134,0,-134
7034,1,1,242,1464,1222
7035,1,1,135,1289,1154
7036,1,1,554,1283,729
7037,1,1,69,1550,1481
7038,1,0,47,0,-47
7039,1,1,59,3474,3415
7040,1,1,93,1408,1315
7041,1,0,33,0,-33
7042,1,0,11,0,-11
7043,1,1,297,1220,923
7044,0,0,171,0,-171
7045,0,0,29,0,-29
7046,0,0,115,0,-115
7047,0,0,69,0,-69
7048,0,0,42,0,-42
7049,0,0,14,0,-14
7050,1,0,60,0,-60
7051,1,1,1660,1524,-136
7052,0,0,19,0,-19
7053,0,0,43,0,-43
7054,1,1,44,1394,1350
7055,0,0,44,0,-44
7056,1,0,9,0,-9
7057,1,0,53,0,-53
7058,0,0,43,0,-43
7059,0,0,32,0,-32
7060,0,0,59,0,-59
7061,1,0,42,0,-42
7062,1,1,544,1518,974
7063,1,0,85,0,-85
7064,1,0,74,0,-74
7065,1,1,119,1526,1407
7066,0,0,9,0,-9
7067,0,0,17,0,-17
7068,1,1,158,1610,1452
7069,1,0,9,0,-9
7070,1,1,906,1374,468
7071,0,0,9,0,-9
7072,0,0,17,0,-17
7073,0,0,15,0,-15
7074,0,0,35,0,-35
7075,1,0,42,0,-42
7076,0,0,144,0,-144
7077,0,0,4,0,-4
7078,1,0,0,0,0
7079,0,0,53,0,-53
7080,1,0,20,0,-20
7081,0,0,87,0,-87
7082,1,0,130,0,-130
7083,1,1,48,1438,1390
7084,0,0,35,0,-35
7085,1,0,46,0,-46
7086,0,0,28,0,-28
7087,0,0,61,0,-61
7088,0,0,35,0,-35
7089,1,1,171,1621,1450
7090,1,0,77,0,-77
7091,1,0,68,0,-68
7092,0,0,102,0,-102
7093,1,1,744,2333,1589
7094,0,0,28,0,-28
7095,0,0,25,0,-25
7096,0,0,27,0,-27
7097,1,1,164,1438,1274
7098,0,0,16,0,-16
7099,1,0,22,0,-22
7100,0,0,28,0,-28
7101,1,0,39,0,-39
7102,0,0,60,0,-60
7103,1,1,485,1740,1255
7104,1,1,192,1304,1112
7105,0,0,43,0,-43
7106,0,0,11,0,-11
7107,1,0,161,0,-161
7108,1,0,51,0,-51
7109,0,0,45,0,-45
7110,0,0,6,0,-6
7111,0,0,16,0,-16
7112,0,0,6,0,-6
7113,1,1,1057,1229,172
7114,1,1,274,1426,1152
7115,0,0,99,0,-99
7116,1,0,1,0,-1
7117,1,1,68,1327,1259
7118,1,1,1700,1412,-288
7119,1,1,278,1261,983
7120,1,1,1808,1574,-234
7121,1,0,7,0,-7
7122,1,1,745,1803,1058
7123,1,1,401,1655,1254
7124,0,0,183,0,-183
7125,1,1,158,1765,1607
7126,1,1,379,1531,1152
7127,0,0,39,0,-39
7128,1,0,13,0,-13
7129,0,0,28,0,-28
7130,1,0,12,0,-12
7131,1,0,9,0,-9
7132,1,1,111,1397,1286
7133,1,1,214,1821,1607
7134,0,0,181,0,-181
7135,0,0,133,0,-133
7136,1,0,40,0,-40
7137,0,0,51,0,-51
7138,0,0,6,0,-6
7139,0,0,39,0,-39
7140,0,0,17,0,-17
7141,0,0,20,0,-20
7142,1,0,69,0,-69
7143,1,1,417,1325,908
7144,1,0,47,0,-47
7145,1,1,607,1543,936
7146,0,0,15,0,-15
7147,0,0,3,0,-3
7148,1,1,289,1681,1392
7149,0,0,38,0,-38
7150,0,0,0,0,0
7151,0,0,28,0,-28
7152,0,0,26,0,-26
7153,1,1,1760,1315,-445
7154,0,0,29,0,-29
7155,0,0,5,0,-5
7156,1,0,6,0,-6
7157,0,0,14,0,-14
7158,0,0,26,0,-26
7159,1,0,7,0,-7
7160,0,0,38,0,-38
7161,1,0,66,0,-66
7162,1,1,455,2113,1658
7163,1,1,487,1574,1087
7164,1,0,152,0,-152
7165,1,1,482,1244,762
7166,0,0,47,0,-47
7167,0,0,54,0,-54
7168,1,0,86,0,-86
7169,0,0,97,0,-97
7170,1,0,1,0,-1
7171,0,0,13,0,-13
7172,1,0,17,0,-17
7173,0,0,140,0,-140
7174,1,0,14,0,-14
7175,1,0,51,0,-51
7176,1,0,9,0,-9
7177,0,0,81,0,-81
7178,1,0,54,0,-54
7179,1,1,1441,1338,-103
7180,1,1,523,1564,1041
7181,0,0,106,0,-106
7182,1,0,71,0,-71
7183,0,0,67,0,-67
7184,1,1,965,1456,491
7185,0,0,54,0,-54
7186,0,0,22,0,-22
7187,1,0,108,0,-108
7188,0,0,40,0,-40
7189,0,0,28,0,-28
7190,1,1,724,1740,1016
7191,1,1,929,1250,321
7192,0,0,35,0,-35
7193,0,0,69,0,-69
7194,0,0,122,0,-122
7195,1,1,1265,1239,-26
7196,0,0,25,0,-25
7197,1,1,100,1278,1178
7198,1,1,197,1591,1394
7199,1,0,46,0,-46
7200,1,1,280,1386,1106
7201,1,0,8,0,-8
7202,1,1,531,1338,807
7203,1,1,357,1624,1267
7204,1,1,357,1200,843
7205,0,0,106,0,-106
7206,1,1,492,1312,820
7207,1,1,461,1232,771
7208,1,0,14,0,-14
7209,1,0,29,0,-29
7210,1,0,5,0,-5
7211,0,0,3,0,-3
7212,0,0,77,0,-77
7213,1,0,32,0,-32
7214,1,1,56,2553,2497
7215,1,0,106,0,-106
7216,1,1,77,1212,1135
7217,0,0,13,0,-13
7218,1,1,137,1252,1115
7219,0,0,61,0,-61
7220,1,0,36,0,-36
7221,1,0,71,0,-71
7222,1,0,52,0,-52
7223,0,0,98,0,-98
7224,0,0,33,0,-33
7225,1,1,413,1369,956
7226,1,1,533,1419,886
7227,1,1,1239,2418,1179
7228,1,1,1360,1736,376
7229,1,1,750,1215,465
7230,0,0,112,0,-112
7231,0,0,64,0,-64
7232,1,1,227,1494,1267
7233,0,0,107,0,-107
7234,1,1,189,1403,1214
7235,0,0,11,0,-11
7236,1,1,278,1255,977
7237,1,0,75,0,-75
7238,1,1,306,1904,1598
7239,0,0,17,0,-17
7240,1,1,186,1443,1257
7241,1,1,93,1306,1213
7242,1,0,66,0,-66
7243,0,0,136,0,-136
7244,0,0,15,0,-15
7245,1,0,0,0,0
7246,1,0,19,0,-19
7247,1,1,66,3048,2982
7248,0,0,45,0,-45
7249,0,0,80,0,-80
7250,1,0,32,0,-32
7251,1,0,5,0,-5
7252,0,0,24,0,-24
7253,1,0,89,0,-89
7254,1,1,435,1858,1423
7255,0,0,68,0,-68
7256,1,0,14,0,-14
7257,1,1,226,1449,1223
7258,1,1,877,1588,711
7259,1,0,49,0,-49
7260,1,1,152,1336,1184
7261,1,1,478,1491,1013
7262,1,1,311,2639,2328
7263,0,0,67,0,-67
7264,1,0,42,0,-42
7265,0,0,131,0,-131
7266,1,0,1,0,-1
7267,1,0,59,0,-59
7268,1,0,18,0,-18
7269,0,0,63,0,-63
7270,1,0,67,0,-67
7271,0,0,18,0,-18
7272,0,0,109,0,-109
7273,0,0,15,0,-15
7274,1,0,52,0,-52
7275,1,0,3,0,-3
7276,0,0,10,0,-10
7277,1,0,131,0,-131
7278,0,0,30,0,-30
7279,0,0,9,0,-9
7280,1,0,81,0,-81
7281,1,1,378,2904,2526
7282,0,0,7,0,-7
7283,1,0,32,0,-32
7284,1,1,258,1726,1468
7285,1,0,2,0,-2
7286,0,0,90,0,-90
7287,0,0,24,0,-24
7288,0,0,27,0,-27
7289,1,1,1141,1226,85
7290,1,1,2279,1585,-694
7291,1,0,91,0,-91
7292,1,0,10,0,-10
7293,1,0,31,0,-31
7294,0,0,14,0,-14
7295,0,0,0,0,0
7296,1,0,22,0,-22
7297,1,0,7,0,-7
7298,0,0,127,0,-127
7299,1,0,90,0,-90
7300,1,1,91,1931,1840
7301,0,0,62,0,-62
7302,0,0,44,0,-44
7303,1,0,61,0,-61
7304,1,0,81,0,-81
7305,0,0,221,0,-221
7306,1,1,275,1276,1001
7307,1,0,57,0,-57
7308,1,0,22,0,-22
7309,0,0,24,0,-24
7310,1,0,1,0,-1
7311,1,1,317,1391,1074
7312,0,0,43,0,-43
7313,0,0,70,0,-70
7314,0,0,73,0,-73
7315,1,0,143,0,-143
7316,1,0,72,0,-72
7317,1,1,251,1802,1551
7318,0,0,69,0,-69
7319,1,0,13,0,-13
7320,1,0,64,0,-64
7321,1,0,28,0,-28
7322,1,1,299,1282,983
7323,0,0,2,0,-2
7324,1,0,4,0,-4
7325,1,1,322,1288,966
7326,1,0,131,0,-131
7327,1,0,38,0,-38
7328,1,0,79,0,-79
7329,0,0,3,0,-3
7330,1,0,15,0,-15
7331,1,0,10,0,-10
7332,1,0,7,0,-7
7333,1,1,161,1247,1086
7334,0,0,7,0,-7
7335,0,0,124,0,-124
7336,0,0,3,0,-3
7337,1,0,11,0,-11
7338,0,0,7,0,-7
7339,1,1,1279,1202,-77
7340,1,0,6,0,-6
7341,0,0,42,0,-42
7342,0,0,12,0,-12
7343,1,1,1193,1837,644
7344,0,0,118,0,-118
7345,1,0,83,0,-83
7346,0,0,121,0,-121
7347,1,0,17,0,-17
7348,1,0,69,0,-69
7349,0,0,70,0,-70
7350,1,0,57,0,-57
7351,1,1,142,1259,1117
7352,1,0,6,0,-6
7353,1,1,820,1215,395
7354,1,1,632,1542,910
7355,0,0,224,0,-224
7356,1,0,30,0,-30
7357,1,0,51,0,-51
7358,1,1,119,1463,1344
7359,0,0,68,0,-68
7360,1,1,744,1215,471
7361,1,0,24,0,-24
7362,0,0,15,0,-15
7363,0,0,164,0,-164
7364,1,1,327,1227,900
7365,1,1,1300,3497,2197
7366,1,0,50,0,-50
7367,0,0,133,0,-133
7368,0,0,128,0,-128
7369,1,0,80,0,-80
7370,1,0,63,0,-63
7371,1,1,269,1255,986
7372,0,0,24,0,-24
7373,1,0,1,0,-1
7374,1,0,35,0,-35
7375,1,0,14,0,-14
7376,1,0,53,0,-53
7377,0,0,27,0,-27
7378,1,1,346,1256,910
7379,0,0,41,0,-41
7380,0,0,12,0,-12
7381,1,1,157,1604,1447
7382,1,0,36,0,-36
7383,0,0,18,0,-18
7384,1,1,410,1347,937
7385,1,0,53,0,-53
7386,0,0,27,0,-27
7387,0,0,4,0,-4
7388,1,0,20,0,-20
7389,1,0,31,0,-31
7390,1,1,790,1476,686
7391,0,0,82,0,-82
7392,1,0,61,0,-61
7393,1,0,48,0,-48
7394,0,0,57,0,-57
7395,0,0,135,0,-135
7396,0,0,73,0,-73
7397,1,0,15,0,-15
7398,1,1,863,1227,364
7399,0,0,5,0,-5
7400,1,0,1,0,-1
7401,0,0,12,0,-12
7402,0,0,65,0,-65
7403,1,1,669,1506,837
7404,0,0,20,0,-20
7405,1,1,177,1549,1372
7406,1,1,463,1235,772
7407,1,0,4,0,-4
7408,0,0,16,0,-16
7409,1,0,3,0,-3
7410,0,0,57,0,-57
7411,1,1,292,1343,1051
7412,0,0,15,0,-15
7413,0,0,69,0,-69
7414,1,0,17,0,-17
7415,0,0,27,0,-27
7416,1,0,16,0,-16
7417,1,1,240,1304,1064
7418,1,1,1019,1275,256
7419,0,0,12,0,-12
7420,1,1,387,1339,952
7421,0,0,119,0,-119
7422,1,0,10,0,-10
7423,0,0,2,0,-2
7424,1,1,59,1296,1237
7425,1,0,8,0,-8
7426,0,0,82,0,-82
7427,1,0,26,0,-26
7428,1,0,66,0,-66
7429,0,0,60,0,-60
7430,0,0,8,0,-8
7431,1,0,47,0,-47
7432,1,1,979,1451,472
7433,1,1,750,1242,492
7434,0,0,72,0,-72
7435,0,0,138,0,-138
7436,1,0,89,0,-89
7437,0,0,2,0,-2
7438,1,1,1065,1654,589
7439,1,0,74,0,-74
7440,1,1,675,1830,1155
7441,1,1,999,1578,579
7442,1,0,42,0,-42
7443,1,0,2,0,-2
7444,1,1,311,1801,1490
7445,0,0,5,0,-5
7446,0,0,47,0,-47
7447,0,0,125,0,-125
7448,1,0,4,0,-4
7449,0,0,28,0,-28
7450,0,0,33,0,-33
7451,0,0,5,0,-5
7452,1,0,5,0,-5
7453,0,0,81,0,-81
7454,1,1,93,1242,1149
7455,1,0,95,0,-95
7456,0,0,38,0,-38
7457,1,1,400,1640,1240
7458,0,0,46,0,-46
7459,0,0,5,0,-5
7460,1,0,0,0,0
7461,0,0,4,0,-4
7462,1,0,155,0,-155
7463,1,0,9,0,-9
7464,1,0,85,0,-85
7465,0,0,53,0,-53
7466,0,0,15,0,-15
7467,1,1,229,1883,1654
7468,0,0,119,0,-119
7469,1,1,510,1315,805
7470,0,0,109,0,-109
7471,0,0,15,0,-15
7472,1,1,608,1238,630
7473,1,0,24,0,-24
7474,1,1,89,1231,1142
7475,1,0,172,0,-172
7476,0,0,32,0,-32
7477,1,0,35,0,-35
7478,1,1,549,2369,1820
7479,1,1,106,1471,1365
7480,1,0,16,0,-16
7481,0,0,137,0,-137
7482,0,0,36,0,-36
7483,1,0,32,0,-32
7484,1,0,71,0,-71
7485,0,0,30,0,-30
7486,1,1,339,1283,944
7487,0,0,73,0,-73
7488,1,1,164,1527,1363
7489,1,1,640,1721,1081
7490,0,0,50,0,-50
7491,0,0,53,0,-53
7492,0,0,37,0,-37
7493,0,0,29,0,-29
7494,0,0,19,0,-19
7495,0,0,34,0,-34
7496,1,1,391,1247,856
7497,0,0,57,0,-57
7498,1,1,369,1444,1075
7499,0,0,13,0,-13
7500,0,0,136,0,-136
7501,0,0,13,0,-13
7502,1,1,197,1467,1270
7503,1,0,5,0,-5
7504,1,1,333,2848,2515
7505,1,0,13,0,-13
7506,1,1,427,1542,1115
7507,0,0,98,0,-98
7508,1,1,649,1462,813
7509,1,0,17,0,-17
7510,1,1,616,1482,866
7511,0,0,24,0,-24
7512,1,1,488,1340,852
7513,0,0,51,0,-51
7514,1,0,9,0,-9
7515,0,0,26,0,-26
7516,0,0,29,0,-29
7517,0,0,38,0,-38
7518,0,0,4,0,-4
7519,0,0,95,0,-95
7520,1,1,888,1400,512
7521,1,0,106,0,-106
7522,1,1,346,1466,1120
7523,0,0,125,0,-125
7524,1,0,24,0,-24
7525,0,0,44,0,-44
7526,1,1,989,1321,332
7527,1,1,998,2596,1598
7528,0,0,62,0,-62
7529,1,1,3539,1252,-2287
7530,1,1,1572,1306,-266
7531,1,0,15,0,-15
7532,1,1,2436,1854,-582
7533,0,0,168,0,-168
7534,1,1,492,1695,1203
7535,0,0,14,0,-14
7536,0,0,35,0,-35
7537,1,1,49,1556,1507
7538,1,0,21,0,-21
7539,1,1,134,1377,1243
7540,0,0,27,0,-27
7541,1,0,62,0,-62
7542,1,1,549,1399,850
7543,1,1,793,1479,686
7544,1,0,12,0,-12
7545,0,0,33,0,-33
7546,1,0,14,0,-14
7547,0,0,2,0,-2
7548,0,0,2,0,-2
7549,1,0,31,0,-31
7550,1,1,587,1241,654
7551,1,0,40,0,-40
7552,0,0,0,0,0
7553,1,0,123,0,-123
7554,1,0,100,0,-100
7555,1,0,59,0,-59
7556,0,0,21,0,-21
7557,0,0,66,0,-66
7558,1,1,861,1238,377
7559,1,1,584,1514,930
7560,1,1,192,1750,1558
7561,1,0,86,0,-86
7562,0,0,152,0,-152
7563,1,0,53,0,-53
7564,1,1,234,1602,1368
7565,1,1,309,1230,921
7566,0,0,35,0,-35
7567,1,1,261,1644,1383
7568,1,0,26,0,-26
7569,0,0,279,0,-279
7570,1,1,698,2153,1455
7571,0,0,95,0,-95
7572,1,1,756,2046,1290
7573,0,0,68,0,-68
7574,0,0,4,0,-4
7575,1,0,20,0,-20
7576,1,0,5,0,-5
7577,0,0,25,0,-25
7578,0,0,140,0,-140
7579,0,0,23,0,-23
7580,1,0,4,0,-4
7581,0,0,112,0,-112
7582,1,1,96,1391,1295
7583,1,1,249,3523,3274
7584,0,0,43,0,-43
7585,1,1,882,1414,532
7586,1,0,83,0,-83
7587,0,0,106,0,-106
7588,1,1,214,1302,1088
7589,1,0,45,0,-45
7590,0,0,15,0,-15
7591,1,0,116,0,-116
7592,0,0,24,0,-24
7593,1,0,204,0,-204
7594,1,1,724,1304,580
7595,0,0,118,0,-118
7596,1,1,331,1241,910
7597,0,0,105,0,-105
7598,0,0,36,0,-36
7599,1,1,293,1418,1125
7600,1,1,294,1254,960
7601,1,1,125,1263,1138
7602,1,0,27,0,-27
7603,1,1,538,1333,795
7604,0,0,28,0,-28
7605,0,0,14,0,-14
7606,0,0,97,0,-97
7607,1,0,21,0,-21
7608,1,0,13,0,-13
7609,0,0,20,0,-20
7610,0,0,209,0,-209
7611,0,0,23,0,-23
7612,0,0,43,0,-43
7613,0,0,61,0,-61
7614,0,0,3,0,-3
7615,1,1,234,1441,1207
7616,1,0,98,0,-98
7617,0,0,2,0,-2
7618,1,1,65,1371,1306
7619,1,0,5,0,-5
7620,1,1,218,1237,1019
7621,0,0,41,0,-41
7622,1,1,387,1483,1096
7623,1,1,139,1310,1171
7624,0,0,42,0,-42
7625,1,0,7,0,-7
7626,0,0,12,0,-12
7627,1,0,22,0,-22
7628,0,0,15,0,-15
7629,1,0,9,0,-9
7630,1,0,61,0,-61
7631,0,0,4,0,-4
7632,0,0,12,0,-12
7633,1,1,134,1677,1543
7634,0,0,20,0,-20
7635,0,0,11,0,-11
7636,0,0,137,0,-137
7637,1,1,828,1640,812
7638,0,0,37,0,-37
7639,0,0,143,0,-143
7640,1,1,432,1277,845
7641,1,1,281,2715,2434
7642,1,0,2,0,-2
7643,1,0,52,0,-52
7644,1,1,367,3925,3558
7645,0,0,37,0,-37
7646,0,0,3,0,-3
7647,1,1,161,1322,1161
7648,1,1,191,1645,1454
7649,1,0,110,0,-110
7650,0,0,52,0,-52
7651,1,0,4,0,-4
7652,0,0,211,0,-211
7653,1,1,485,1961,1476
7654,0,0,49,0,-49
7655,1,0,0,0,0
7656,1,0,65,0,-65
7657,1,1,209,1340,1131
7658,0,0,34,0,-34
7659,0,0,3,0,-3
7660,1,0,27,0,-27
7661,1,1,173,1532,1359
7662,1,0,8,0,-8
7663,1,1,1128,1672,544
7664,1,1,80,2338,2258
7665,0,0,7,0,-7
7666,1,1,153,1218,1065
7667,0,0,39,0,-39
7668,0,0,13,0,-13
7669,1,1,50,1511,1461
7670,1,0,67,0,-67
7671,0,0,35,0,-35
7672,1,1,660,1277,617
7673,1,0,17,0,-17
7674,0,0,76,0,-76
7675,0,0,11,0,-11
7676,0,0,58,0,-58
7677,1,1,555,1387,832
7678,0,0,41,0,-41
7679,1,1,184,1521,1337
7680,0,0,30,0,-30
7681,0,0,64,0,-64
7682,1,1,1212,1377,165
7683,1,0,129,0,-129
7684,0,0,11,0,-11
7685,0,0,75,0,-75
7686,1,1,963,1320,357
7687,0,0,18,0,-18
7688,0,0,127,0,-127
7689,1,1,344,1471,1127
7690,1,1,878,1454,576
7691,0,0,20,0,-20
7692,0,0,33,0,-33
7693,1,1,223,1409,1186
7694,0,0,110,0,-110
7695,1,1,24,1242,1218
7696,0,0,25,0,-25
7697,0,0,3,0,-3
7698,1,0,61,0,-61
7699,1,1,148,1573,1425
7700,0,0,9,0,-9
7701,0,0,22,0,-22
7702,0,0,12,0,-12
7703,0,0,32,0,-32
7704,1,0,4,0,-4
7705,1,0,76,0,-76
7706,1,1,285,1765,1480
7707,1,0,14,0,-14
7708,0,0,6,0,-6
7709,1,1,1066,1235,169
7710,0,0,3,0,-3
7711,1,1,119,1533,1414
7712,1,1,1276,1307,31
7713,0,0,14,0,-14
7714,1,1,370,1274,904
7715,1,0,64,0,-64
7716,0,0,4,0,-4
7717,0,0,42,0,-42
7718,1,1,355,1626,1271
7719,0,0,4,0,-4
7720,1,1,1197,1380,183
7721,1,1,215,1824,1609
7722,0,0,127,0,-127
7723,1,1,502,1275,773
7724,0,0,19,0,-19
7725,1,1,279,1919,1640
7726,0,0,18,0,-18
7727,0,0,2,0,-2
7728,0,0,11,0,-11
7729,0,0,2,0,-2
7730,0,0,58,0,-58
7731,0,0,79,0,-79
7732,0,0,68,0,-68
7733,1,0,30,0,-30
7734,0,0,80,0,-80
7735,1,0,30,0,-30
7736,0,0,48,0,-48
7737,1,0,24,0,-24
7738,1,0,67,0,-67
7739,0,0,54,0,-54
7740,1,0,2,0,-2
7741,1,0,9,0,-9
7742,1,0,45,0,-45
7743,1,0,162,0,-162
7744,0,0,77,0,-77
7745,1,1,1599,1333,-266
7746,1,0,61,0,-61
7747,1,0,1,0,-1
7748,0,0,24,0,-24
7749,0,0,52,0,-52
7750,1,0,109,0,-109
7751,0,0,52,0,-52
7752,1,0,47,0,-47
7753,0,0,10,0,-10
7754,1,1,278,1219,941
7755,1,1,268,1205,937
7756,0,0,14,0,-14
7757,0,0,9,0,-9
7758,0,0,70,0,-70
7759,1,1,367,1241,874
7760,1,1,329,1515,1186
7761,0,0,7,0,-7
7762,1,1,382,1511,1129
7763,0,0,37,0,-37
7764,1,0,47,0,-47
7765,0,0,46,0,-46
7766,1,0,32,0,-32
7767,1,1,232,1808,1576
7768,0,0,26,0,-26
7769,0,0,91,0,-91
7770,0,0,27,0,-27
7771,0,0,89,0,-89
7772,1,1,486,2793,2307
7773,1,1,396,1523,1127
7774,1,0,2,0,-2
7775,1,1,157,1745,1588
7776,1,0,107,0,-107
7777,1,1,145,1244,1099
7778,0,0,4,0,-4
7779,0,0,74,0,-74
7780,1,0,4,0,-4
7781,1,1,260,1891,1631
7782,0,0,25,0,-25
7783,1,0,25,0,-25
7784,0,0,17,0,-17
7785,1,0,44,0,-44
7786,0,0,37,0,-37
7787,1,1,1004,1270,266
7788,0,0,16,0,-16
7789,1,0,26,0,-26
7790,0,0,2,0,-2
7791,1,1,882,1885,1003
7792,1,1,327,3271,2944
7793,1,0,5,0,-5
7794,0,0,133,0,-133
7795,1,1,84,1472,1388
7796,1,0,11,0,-11
7797,0,0,27,0,-27
7798,0,0,110,0,-110
7799,1,0,46,0,-46
7800,1,0,101,0,-101
7801,1,1,228,1275,1047
7802,0,0,9,0,-9
7803,0,0,10,0,-10
7804,0,0,25,0,-25
7805,0,0,89,0,-89
7806,1,0,4,0,-4
7807,0,0,84,0,-84
7808,1,0,66,0,-66
7809,1,1,463,1265,802
7810,1,1,575,1802,1227
7811,1,1,847,1203,356
7812,1,1,200,1633,1433
7813,0,0,11,0,-11
7814,0,0,28,0,-28
7815,0,0,1,0,-1
7816,1,1,357,2837,2480
7817,1,0,14,0,-14
7818,0,0,18,0,-18
7819,0,0,53,0,-53
7820,0,0,68,0,-68
7821,1,0,53,0,-53
7822,1,1,620,1380,760
7823,0,0,28,0,-28
7824,0,0,62,0,-62
7825,1,1,1222,1276,54
7826,0,0,10,0,-10
7827,0,0,54,0,-54
7828,1,1,224,1397,1173
7829,1,1,110,1661,1551
7830,0,0,187,0,-187
7831,1,0,24,0,-24
7832,1,1,151,1422,1271
7833,1,0,53,0,-53
7834,0,0,13,0,-13
7835,1,1,2134,1738,-396
7836,1,1,1275,1706,431
7837,1,0,19,0,-19
7838,1,1,868,1235,367
7839,1,0,31,0,-31
7840,1,0,22,0,-22
7841,1,1,213,1246,1033
7842,1,0,37,0,-37
7843,1,0,129,0,-129
7844,0,0,26,0,-26
7845,1,0,2,0,-2
7846,1,1,444,1212,768
7847,1,1,196,1211,1015
7848,0,0,54,0,-54
7849,0,0,5,0,-5
7850,0,0,34,0,-34
7851,0,0,12,0,-12
7852,0,0,52,0,-52
7853,1,0,47,0,-47
7854,1,1,957,1453,496
7855,1,1,309,1485,1176
7856,1,1,141,1203,1062
7857,1,1,1837,1285,-552
7858,0,0,119,0,-119
7859,0,0,23,0,-23
7860,1,0,146,0,-146
7861,1,1,912,1392,480
7862,0,0,1,0,-1
7863,0,0,51,0,-51
7864,0,0,36,0,-36
7865,0,0,179,0,-179
7866,1,1,216,1291,1075
7867,0,0,93,0,-93
7868,1,0,3,0,-3
7869,1,0,2,0,-2
7870,1,1,291,1503,1212
7871,1,1,793,1642,849
7872,0,0,30,0,-30
7873,1,1,398,1202,804
7874,0,0,2,0,-2
7875,0,0,55,0,-55
7876,1,0,79,0,-79
7877,0,0,109,0,-109
7878,1,0,36,0,-36
7879,1,1,545,1417,872
7880,1,1,1391,2633,1242
7881,1,1,120,1581,1461
7882,1,1,924,1672,748
7883,1,0,49,0,-49
7884,1,0,3,0,-3
7885,1,1,296,1804,1508
7886,1,1,55,1365,1310
7887,1,1,421,1236,815
7888,1,1,448,2057,1609
7889,1,0,33,0,-33
7890,1,0,50,0,-50
7891,0,0,89,0,-89
7892,0,0,47,0,-47
7893,1,0,66,0,-66
7894,1,1,736,1206,470
7895,0,0,32,0,-32
7896,1,0,34,0,-34
7897,1,1,934,1962,1028
7898,1,0,2,0,-2
7899,0,0,20,0,-20
7900,0,0,39,0,-39
7901,1,1,448,1741,1293
7902,1,1,533,2372,1839
7903,0,0,14,0,-14
7904,1,1,140,1452,1312
7905,1,0,6,0,-6
7906,1,0,100,0,-100
7907,1,0,50,0,-50
7908,0,0,40,0,-40
7909,1,0,115,0,-115
7910,0,0,31,0,-31
7911,1,1,1612,1499,-113
7912,0,0,25,0,-25
7913,0,0,89,0,-89
7914,0,0,13,0,-13
7915,1,0,6,0,-6
7916,0,0,10,0,-10
7917,1,1,163,1281,1118
7918,0,0,78,0,-78
7919,0,0,25,0,-25
7920,0,0,6,0,-6
7921,0,0,7,0,-7
7922,0,0,18,0,-18
7923,1,0,1,0,-1
7924,0,0,73,0,-73
7925,1,0,55,0,-55
7926,1,0,87,0,-87
7927,1,0,58,0,-58
7928,0,0,67,0,-67
7929,1,0,4,0,-4
7930,1,0,197,0,-197
7931,1,1,139,1467,1328
7932,1,1,181,1462,1281
7933,0,0,88,0,-88
7934,0,0,87,0,-87
7935,1,1,861,1276,415
7936,1,1,528,1211,683
7937,0,0,30,0,-30
7938,1,1,154,1804,1650
7939,1,0,16,0,-16
7940,0,0,10,0,-10
7941,0,0,61,0,-61
7942,0,0,133,0,-133
7943,0,0,49,0,-49
7944,1,1,778,1868,1090
7945,1,0,8,0,-8
7946,0,0,157,0,-157
7947,1,0,33,0,-33
7948,0,0,7,0,-7
7949,0,0,24,0,-24
7950,1,0,59,0,-59
7951,0,0,28,0,-28
7952,0,0,67,0,-67
7953,0,0,11,0,-11
7954,1,1,173,1473,1300
7955,1,0,69,0,-69
7956,0,0,169,0,-169
7957,0,0,5,0,-5
7958,0,0,3,0,-3
7959,1,1,198,1591,1393
7960,0,0,32,0,-32
7961,1,1,23,1303,1280
7962,1,1,207,1793,1586
7963,0,0,38,0,-38
7964,1,1,199,1922,1723
7965,0,0,52,0,-52
7966,1,1,739,1282,543
7967,1,0,122,0,-122
7968,1,1,330,1247,917
7969,0,0,62,0,-62
7970,1,1,140,1430,1290
7971,0,0,48,0,-48
7972,1,0,39,0,-39
7973,1,0,56,0,-56
7974,1,0,2,0,-2
7975,1,0,123,0,-123
7976,1,0,32,0,-32
7977,1,1,316,3220,2904
7978,1,0,38,0,-38
7979,1,0,2,0,-2
7980,1,0,18,0,-18
7981,0,0,28,0,-28
7982,1,0,96,0,-96
7983,0,0,20,0,-20
7984,1,0,59,0,-59
7985,0,0,0,0,0
7986,1,0,98,0,-98
7987,1,1,40,1270,1230
7988,0,0,11,0,-11
7989,1,0,29,0,-29
7990,1,1,478,1380,902
7991,0,0,37,0,-37
7992,0,0,12,0,-12
7993,1,0,12,0,-12
7994,1,0,36,0,-36
7995,0,0,15,0,-15
7996,0,0,62,0,-62
7997,0,0,1,0,-1
7998,1,0,18,0,-18
7999,0,0,15,0,-15
8000,0,0,24,0,-24
8001,0,0,2,0,-2
8002,1,0,98,0,-98
8003,0,0,18,0,-18
8004,1,1,145,1792,1647
8005,1,0,89,0,-89
8006,1,1,826,1500,674
8007,0,0,138,0,-138
8008,1,0,1,0,-1
8009,1,0,16,0,-16
8010,0,0,9,0,-9
8011,1,1,86,1547,1461
8012,1,0,50,0,-50
8013,0,0,128,0,-128
8014,1,0,10,0,-10
8015,1,0,26,0,-26
8016,1,0,237,0,-237
8017,0,0,44,0,-44
8018,0,0,5,0,-5
8019,1,1,92,1258,1166
8020,0,0,55,0,-55
8021,0,0,40,0,-40
8022,1,0,80,0,-80
8023,0,0,5,0,-5
8024,1,1,77,1214,1137
8025,0,0,46,0,-46
8026,1,0,113,0,-113
8027,1,0,41,0,-41
8028,1,0,194,0,-194
8029,1,0,23,0,-23
8030,0,0,54,0,-54
8031,1,0,32,0,-32
8032,0,0,32,0,-32
8033,1,1,143,1209,1066
8034,0,0,46,0,-46
8035,0,0,141,0,-141
8036,1,0,202,0,-202
8037,1,1,752,1683,931
8038,1,1,589,1625,1036
8039,0,0,17,0,-17
8040,1,1,62,2172,2110
8041,1,0,41,0,-41
8042,1,1,117,4578,4461
8043,0,0,189,0,-189
8044,1,1,50,1589,1539
8045,0,0,20,0,-20
8046,0,0,89,0,-89
8047,1,1,139,1395,1256
8048,1,1,2500,1237,-1263
8049,0,0,37,0,-37
8050,0,0,152,0,-152
8051,1,1,209,1545,1336
8052,1,1,243,1205,962
8053,1,1,422,1383,961
8054,0,0,15,0,-15
8055,1,0,11,0,-11
8056,0,0,11,0,-11
8057,0,0,38,0,-38
8058,1,0,70,0,-70
8059,1,0,11,0,-11
8060,1,1,1251,3116,1865
8061,1,1,592,1209,617
8062,0,0,17,0,-17
8063,1,1,79,1510,1431
8064,1,0,4,0,-4
8065,0,0,42,0,-42
8066,1,0,44,0,-44
8067,0,0,5,0,-5
8068,1,1,118,1919,1801
8069,0,0,193,0,-193
8070,1,0,1,0,-1
8071,0,0,43,0,-43
8072,1,1,1931,1352,-579
8073,0,0,35,0,-35
8074,1,0,166,0,-166
8075,1,0,170,0,-170
8076,1,1,186,1443,1257
8077,1,0,14,0,-14
8078,0,0,1,0,-1
8079,1,0,29,0,-29
8080,0,0,7,0,-7
8081,0,0,27,0,-27
8082,0,0,2,0,-2
8083,0,0,6,0,-6
8084,1,0,67,0,-67
8085,0,0,27,0,-27
8086,1,0,17,0,-17
8087,1,1,415,1200,785
8088,1,1,192,1875,1683
8089,1,0,29,0,-29
8090,1,1,522,2114,1592
8091,1,0,2,0,-2
8092,0,0,51,0,-51
8093,1,1,252,1207,955
8094,1,0,35,0,-35
8095,0,0,28,0,-28
8096,1,0,14,0,-14
8097,0,0,6,0,-6
8098,1,1,554,1481,927
8099,1,1,752,1327,575
8100,0,0,24,0,-24
8101,0,0,23,0,-23
8102,0,0,15,0,-15
8103,1,1,840,1473,633
8104,1,1,711,1244,533
8105,1,1,413,1283,870
8106,1,1,808,1275,467
8107,0,0,53,0,-53
8108,1,1,327,1221,894
8109,1,1,225,1243,1018
8110,1,1,437,1861,1424
8111,1,1,651,1392,741
8112,1,1,114,1438,1324
8113,0,0,2,0,-2
8114,0,0,27,0,-27
8115,1,1,786,1424,638
8116,1,0,27,0,-27
8117,0,0,33,0,-33
8118,1,1,82,2066,1984
8119,1,0,132,0,-132
8120,1,1,467,3283,2816
8121,0,0,0,0,0
8122,1,0,5,0,-5
8123,0,0,13,0,-13
8124,1,0,67,0,-67
8125,1,0,178,0,-178
8126,1,1,299,1316,1017
8127,0,0,5,0,-5
8128,0,0,0,0,0
8129,1,0,2,0,-2
8130,1,1,630,1220,590
8131,1,1,265,1522,1257
8132,0,0,18,0,-18
8133,1,1,178,1360,1182
8134,1,0,20,0,-20
8135,1,1,1109,1734,625
8136,1,0,29,0,-29
8137,0,0,1,0,-1
8138,1,0,63,0,-63
8139,1,1,610,1630,1020
8140,1,1,190,1284,1094
8141,1,0,7,0,-7
8142,1,0,0,0,0
8143,0,0,90,0,-90
8144,1,1,245,2699,2454
8145,0,0,68,0,-68
8146,0,0,13,0,-13
8147,1,0,30,0,-30
8148,0,0,22,0,-22
8149,0,0,49,0,-49
8150,0,0,88,0,-88
8151,1,0,26,0,-26
8152,1,1,151,2390,2239
8153,0,0,52,0,-52
8154,1,0,51,0,-51
8155,0,0,37,0,-37
8156,0,0,61,0,-61
8157,1,1,725,1376,651
8158,0,0,68,0,-68
8159,1,0,99,0,-99
8160,0,0,44,0,-44
8161,1,0,25,0,-25
8162,1,1,1348,1384,36
8163,0,0,19,0,-19
8164,0,0,9,0,-9
8165,0,0,22,0,-22
8166,0,0,12,0,-12
8167,1,1,1080,2150,1070
8168,1,0,46,0,-46
8169,0,0,6,0,-6
8170,0,0,1,0,-1
8171,0,0,34,0,-34
8172,0,0,8,0,-8
8173,1,1,202,1223,1021
8174,0,0,106,0,-106
8175,1,0,40,0,-40
8176,1,1,379,1337,958
8177,1,0,67,0,-67
8178,0,0,0,0,0
8179,1,1,2487,1605,-882
8180,0,0,61,0,-61
8181,0,0,110,0,-110
8182,0,0,9,0,-9
8183,1,1,1094,1587,493
8184,0,0,28,0,-28
8185,1,0,177,0,-177
8186,0,0,10,0,-10
8187,1,1,253,1293,1040
8188,0,0,13,0,-13
8189,0,0,53,0,-53
8190,0,0,30,0,-30
8191,0,0,41,0,-41
8192,1,0,33,0,-33
8193,0,0,24,0,-24
8194,1,1,39,2484,2445
8195,1,0,4,0,-4
8196,0,0,12,0,-12
8197,0,0,22,0,-22
8198,1,0,36,0,-36
8199,1,0,16,0,-16
8200,0,0,4,0,-4
8201,1,1,75,1896,1821
8202,0,0,4,0,-4
8203,1,1,155,1395,1240
8204,1,1,804,1428,624
8205,0,0,2,0,-2
8206,0,0,15,0,-15
8207,1,1,1951,2054,103
8208,0,0,78,0,-78
8209,1,0,82,0,-82
8210,0,0,39,0,-39
8211,1,0,82,0,-82
8212,1,1,386,1309,923
8213,1,1,397,1519,1122
8214,0,0,3,0,-3
8215,0,0,69,0,-69
8216,1,1,939,1861,922
8217,1,1,189,1258,1069
8218,0,0,34,0,-34
8219,0,0,31,0,-31
8220,1,1,764,1434,670
8221,1,0,2,0,-2
8222,0,0,12,0,-12
8223,1,0,80,0,-80
8224,1,1,1049,1587,538
8225,0,0,45,0,-45
8226,0,0,17,0,-17
8227,0,0,112,0,-112
8228,1,1,100,1213,1113
8229,0,0,51,0,-51
8230,0,0,0,0,0
8231,0,0,19,0,-19
8232,1,1,2092,1372,-720
8233,1,1,69,1751,1682
8234,1,0,37,0,-37
8235,0,0,19,0,-19
8236,1,1,99,1333,1234
8237,1,0,23,0,-23
8238,0,0,109,0,-109
8239,1,0,11,0,-11
8240,1,0,56,0,-56
8241,1,0,22,0,-22
8242,0,0,35,0,-35
8243,0,0,81,0,-81
8244,0,0,117,0,-117
8245,0,0,12,0,-12
8246,1,0,9,0,-9
8247,1,0,26,0,-26
8248,0,0,6,0,-6
8249,1,1,862,1289,427
8250,1,0,103,0,-103
8251,0,0,10,0,-10
8252,1,1,850,1439,589
8253,0,0,62,0,-62
8254,1,0,38,0,-38
8255,0,0,79,0,-79
8256,0,0,13,0,-13
8257,1,0,6,0,-6
8258,1,1,423,1945,1522
8259,0,0,47,0,-47
8260,0,0,204,0,-204
8261,1,1,606,1349,743
8262,0,0,66,0,-66
8263,1,0,20,0,-20
8264,0,0,7,0,-7
8265,1,1,203,1284,1081
8266,1,1,353,1620,1267
8267,1,0,22,0,-22
8268,1,1,677,1253,576
8269,0,0,44,0,-44
8270,1,1,702,1454,752
8271,0,0,23,0,-23
8272,0,0,32,0,-32
8273,0,0,43,0,-43
8274,0,0,44,0,-44
8275,1,0,37,0,-37
8276,0,0,25,0,-25
8277,0,0,70,0,-70
8278,1,0,5,0,-5
8279,1,0,18,0,-18
8280,1,0,66,0,-66
8281,0,0,100,0,-100
8282,0,0,23,0,-23
8283,1,0,30,0,-30
8284,0,0,66,0,-66
8285,1,0,31,0,-31
8286,0,0,2,0,-2
8287,1,0,105,0,-105
8288,1,0,212,0,-212
8289,1,1,80,1532,1452
8290,0,0,6,0,-6
8291,0,0,44,0,-44
8292,1,0,59,0,-59
8293,1,0,80,0,-80
8294,1,0,19,0,-19
8295,0,0,6,0,-6
8296,1,0,17,0,-17
8297,1,0,13,0,-13
8298,1,0,7,0,-7
8299,1,0,75,0,-75
8300,1,0,43,0,-43
8301,0,0,66,0,-66
8302,1,0,22,0,-22
8303,0,0,47,0,-47
8304,1,0,98,0,-98
8305,1,0,9,0,-9
8306,1,1,361,1205,844
8307,0,0,28,0,-28
8308,1,1,1087,1581,494
8309,1,1,521,1205,684
8310,0,0,26,0,-26
8311,0,0,47,0,-47
8312,0,0,17,0,-17
8313,1,1,127,1321,1194
8314,0,0,0,0,0
8315,1,0,5,0,-5
8316,1,0,88,0,-88
8317,0,0,46,0,-46
8318,1,1,35,1215,1180
8319,1,0,59,0,-59
8320,0,0,118,0,-118
8321,1,0,154,0,-154
8322,1,0,152,0,-152
8323,1,1,367,3572,3205
8324,0,0,90,0,-90
8325,1,0,34,0,-34
8326,0,0,72,0,-72
8327,0,0,43,0,-43
8328,1,0,99,0,-99
8329,1,1,272,2053,1781
8330,1,1,216,1480,1264
8331,0,0,20,0,-20
8332,1,1,208,1568,1360
8333,1,0,114,0,-114
8334,1,0,65,0,-65
8335,0,0,227,0,-227
8336,0,0,27,0,-27
8337,1,1,139,1605,1466
8338,0,0,43,0,-43
8339,0,0,34,0,-34
8340,1,1,895,1450,555
8341,0,0,144,0,-144
8342,0,0,24,0,-24
8343,0,0,14,0,-14
8344,1,1,505,1270,765
8345,1,1,374,1305,931
8346,1,1,352,1234,882
8347,1,0,11,0,-11
8348,1,1,72,1302,1230
8349,1,0,59,0,-59
8350,1,1,269,1766,1497
8351,1,0,23,0,-23
8352,0,0,36,0,-36
8353,1,1,238,1406,1168
8354,1,1,401,1577,1176
8355,1,1,1222,1338,116
8356,1,1,273,1813,1540
8357,1,0,29,0,-29
8358,1,0,58,0,-58
8359,1,0,134,0,-134
8360,1,1,343,1257,914
8361,1,1,240,1297,1057
8362,1,0,14,0,-14
8363,1,1,644,3422,2778
8364,1,0,33,0,-33
8365,1,1,517,1221,704
8366,1,0,13,0,-13
8367,1,1,532,1214,682
8368,1,0,0,0,0
8369,0,0,64,0,-64
8370,1,0,1,0,-1
8371,0,0,35,0,-35
8372,1,1,180,1214,1034
8373,1,0,47,0,-47
8374,1,1,81,2419,2338
8375,1,1,45,3154,3109
8376,1,0,73,0,-73
8377,1,0,113,0,-113
8378,1,0,118,0,-118
8379,1,1,116,1378,1262
8380,0,0,0,0,0
8381,0,0,79,0,-79
8382,1,1,489,1371,882
8383,0,0,24,0,-24
8384,0,0,34,0,-34
8385,1,0,8,0,-8
8386,1,0,241,0,-241
8387,1,1,948,1577,629
8388,1,0,158,0,-158
8389,1,0,151,0,-151
8390,1,1,655,1712,1057
8391,1,1,786,1276,490
8392,1,1,911,1213,302
8393,1,1,44,1880,1836
8394,0,0,48,0,-48
8395,1,0,80,0,-80
8396,1,1,240,1593,1353
8397,1,1,472,2577,2105
8398,1,1,29,1793,1764
8399,1,1,337,1326,989
8400,0,0,121,0,-121
8401,0,0,25,0,-25
8402,1,1,169,1454,1285
8403,1,0,86,0,-86
8404,0,0,37,0,-37
8405,1,1,156,1997,1841
8406,1,1,382,1568,1186
8407,1,1,154,1570,1416
8408,0,0,15,0,-15
8409,0,0,98,0,-98
8410,1,1,343,1209,866
8411,1,1,449,1232,783
8412,0,0,24,0,-24
8413,1,0,127,0,-127
8414,1,1,461,1219,758
8415,1,1,599,1786,1187
8416,0,0,10,0,-10
8417,1,1,46,1920,1874
8418,0,0,16,0,-16
8419,1,1,547,1295,748
8420,1,0,68,0,-68
8421,1,0,35,0,-35
8422,0,0,92,0,-92
8423,0,0,46,0,-46
8424,1,0,33,0,-33
8425,1,1,11,1596,1585
8426,1,1,558,1883,1325
8427,0,0,38,0,-38
8428,1,0,2,0,-2
8429,1,1,464,1373,909
8430,1,1,240,1504,1264
8431,0,0,49,0,-49
8432,1,0,2,0,-2
8433,1,1,265,1494,1229
8434,1,0,39,0,-39
8435,1,0,57,0,-57
8436,1,1,134,1444,1310
8437,0,0,59,0,-59
8438,0,0,83,0,-83
8439,1,0,172,0,-172
8440,0,0,24,0,-24
8441,0,0,23,0,-23
8442,0,0,20,0,-20
8443,0,0,68,0,-68
8444,1,1,1019,1896,877
8445,1,0,2,0,-2
8446,1,1,688,1409,721
8447,1,0,78,0,-78
8448,0,0,112,0,-112
8449,1,1,15,1221,1206
8450,0,0,1,0,-1
8451,0,0,7,0,-7
8452,0,0,2,0,-2
8453,0,0,7,0,-7
8454,1,0,5,0,-5
8455,0,0,17,0,-17
8456,1,1,1255,1295,40
8457,0,0,19,0,-19
8458,0,0,7,0,-7
8459,1,1,478,1556,1078
8460,1,0,18,0,-18
8461,0,0,32,0,-32
8462,0,0,60,0,-60
8463,1,0,157,0,-157
8464,0,0,21,0,-21
8465,0,0,68,0,-68
8466,1,0,42,0,-42
8467,1,1,327,1231,904
8468,0,0,21,0,-21
8469,1,0,29,0,-29
8470,1,0,47,0,-47
8471,1,0,17,0,-17
8472,1,0,42,0,-42
8473,1,0,52,0,-52
8474,0,0,9,0,-9
8475,0,0,53,0,-53
8476,1,0,42,0,-42
8477,1,1,1561,1232,-329
8478,1,1,139,1665,1526
8479,0,0,48,0,-48
8480,0,0,85,0,-85
8481,1,0,63,0,-63
8482,1,0,37,0,-37
8483,0,0,33,0,-33
8484,1,0,74,0,-74
8485,0,0,6,0,-6
8486,1,0,40,0,-40
8487,0,0,218,0,-218
8488,0,0,0,0,0
8489,1,0,5,0,-5
8490,1,0,3,0,-3
8491,1,1,1021,1256,235
8492,0,0,32,0,-32
8493,1,0,45,0,-45
8494,0,0,1,0,-1
8495,1,1,186,1286,1100
8496,1,1,740,1385,645
8497,1,0,37,0,-37
8498,0,0,27,0,-27
8499,0,0,48,0,-48
8500,1,1,343,1639,1296
8501,1,1,830,1736,906
8502,0,0,6,0,-6
8503,0,0,67,0,-67
8504,1,1,457,1318,861
8505,0,0,41,0,-41
8506,1,1,128,1259,1131
8507,1,1,49,1734,1685
8508,0,0,5,0,-5
8509,1,1,1078,1648,570
8510,1,1,129,1703,1574
8511,1,0,50,0,-50
8512,1,0,5,0,-5
8513,0,0,109,0,-109
8514,1,1,616,1419,803
8515,0,0,15,0,-15
8516,1,1,131,1227,1096
8517,1,0,22,0,-22
8518,1,0,48,0,-48
8519,0,0,161,0,-161
8520,1,1,2472,1800,-672
8521,1,1,432,1237,805
8522,1,1,168,1527,1359
8523,0,0,10,0,-10
8524,0,0,10,0,-10
8525,0,0,67,0,-67
8526,1,1,416,1681,1265
8527,0,0,62,0,-62
8528,0,0,40,0,-40
8529,1,0,114,0,-114
8530,0,0,138,0,-138
8531,1,0,1,0,-1
8532,0,0,56,0,-56
8533,1,1,2027,1220,-807
8534,0,0,1,0,-1
8535,1,1,559,2810,2251
8536,0,0,6,0,-6
8537,1,0,125,0,-125
8538,0,0,64,0,-64
8539,0,0,54,0,-54
8540,0,0,47,0,-47
8541,0,0,124,0,-124
8542,1,1,154,1231,1077
8543,1,1,92,1387,1295
8544,0,0,1,0,-1
8545,1,1,526,1594,1068
8546,1,1,229,1264,1035
8547,0,0,75,0,-75
8548,1,0,90,0,-90
8549,1,1,502,1315,813
8550,1,0,57,0,-57
8551,1,0,35,0,-35
8552,0,0,72,0,-72
8553,0,0,37,0,-37
8554,0,0,1,0,-1
8555,1,1,26,1315,1289
8556,0,0,18,0,-18
8557,1,1,803,1644,841
8558,0,0,43,0,-43
8559,1,0,10,0,-10
8560,1,1,453,1333,880
8561,0,0,57,0,-57
8562,0,0,65,0,-65
8563,0,0,13,0,-13
8564,1,1,261,1468,1207
8565,1,0,6,0,-6
8566,0,0,53,0,-53
8567,1,1,1398,1259,-139
8568,0,0,19,0,-19
8569,0,0,69,0,-69
8570,1,0,64,0,-64
8571,1,1,407,1384,977
8572,0,0,3,0,-3
8573,0,0,17,0,-17
8574,0,0,5,0,-5
8575,0,0,100,0,-100
8576,1,0,16,0,-16
8577,0,0,6,0,-6
8578,1,1,5,1607,1602
8579,0,0,15,0,-15
8580,1,0,0,0,0
8581,0,0,57,0,-57
8582,1,1,29,1691,1662
8583,0,0,83,0,-83
8584,0,0,6,0,-6
8585,0,0,17,0,-17
8586,0,0,54,0,-54
8587,1,0,10,0,-10
8588,0,0,74,0,-74
8589,1,1,783,1305,522
8590,0,0,87,0,-87
8591,0,0,49,0,-49
8592,1,1,385,1209,824
8593,1,0,17,0,-17
8594,1,1,43,1861,1818
8595,1,0,82,0,-82
8596,0,0,150,0,-150
8597,1,1,264,1375,1111
8598,0,0,32,0,-32
8599,1,0,22,0,-22
8600,1,0,121,0,-121
8601,1,1,19,1964,1945
8602,1,1,18,1220,1202
8603,1,0,35,0,-35
8604,1,1,293,1529,1236
8605,1,0,55,0,-55
8606,1,1,1018,1326,308
8607,0,0,170,0,-170
8608,0,0,1,0,-1
8609,1,0,36,0,-36
8610,0,0,24,0,-24
8611,0,0,61,0,-61
8612,1,1,99,1792,1693
8613,1,0,31,0,-31
8614,0,0,99,0,-99
8615,0,0,22,0,-22
8616,0,0,2,0,-2
8617,0,0,77,0,-77
8618,1,1,273,1384,1111
8619,0,0,69,0,-69
8620,1,1,1240,2021,781
8621,1,0,7,0,-7
8622,1,0,7,0,-7
8623,0,0,10,0,-10
8624,1,1,303,1462,1159
8625,1,0,27,0,-27
8626,1,1,670,1565,895
8627,1,0,264,0,-264
8628,0,0,42,0,-42
8629,1,1,502,1489,987
8630,1,0,26,0,-26
8631,0,0,16,0,-16
8632,0,0,74,0,-74
8633,1,0,18,0,-18
8634,1,0,0,0,0
8635,1,0,26,0,-26
8636,1,0,134,0,-134
8637,1,1,575,1268,693
8638,1,1,726,1230,504
8639,0,0,15,0,-15
8640,1,0,48,0,-48
8641,0,0,47,0,-47
8642,1,0,52,0,-52
8643,1,1,554,1477,923
8644,1,1,260,1389,1129
8645,1,1,1210,1447,237
8646,0,0,6,0,-6
8647,0,0,7,0,-7
8648,1,1,24,2292,2268
8649,0,0,21,0,-21
8650,0,0,71,0,-71
8651,1,0,16,0,-16
8652,1,1,242,1436,1194
8653,0,0,87,0,-87
8654,1,1,29,1214,1185
8655,0,0,38,0,-38
8656,1,1,184,1364,1180
8657,0,0,18,0,-18
8658,1,0,26,0,-26
8659,1,1,1629,1325,-304
8660,1,0,71,0,-71
8661,0,0,42,0,-42
8662,0,0,21,0,-21
8663,0,0,14,0,-14
8664,1,0,34,0,-34
8665,1,1,294,1379,1085
8666,1,1,2765,1225,-1540
8667,1,0,0,0,0
8668,1,1,169,1298,1129
8669,1,1,114,1550,1436
8670,0,0,18,0,-18
8671,0,0,4,0,-4
8672,1,1,123,1362,1239
8673,0,0,145,0,-145
8674,1,1,151,1399,1248
8675,1,0,6,0,-6
8676,1,1,448,1215,767
8677,0,0,25,0,-25
8678,1,1,676,1347,671
8679,0,0,16,0,-16
8680,0,0,7,0,-7
8681,1,1,1048,1327,279
8682,1,1,261,1474,1213
8683,1,1,114,1865,1751
8684,1,1,518,1331,813
8685,1,0,2,0,-2
8686,0,0,66,0,-66
8687,0,0,100,0,-100
8688,1,1,656,1309,653
8689,1,1,2078,4310,2232
8690,1,0,74,0,-74
8691,1,1,140,5187,5047
8692,0,0,8,0,-8
8693,0,0,19,0,-19
8694,0,0,28,0,-28
8695,1,0,38,0,-38
8696,1,1,1415,2516,1101
8697,0,0,98,0,-98
8698,1,1,245,1417,1172
8699,0,0,167,0,-167
8700,1,1,858,1237,379
8701,1,0,8,0,-8
8702,1,0,9,0,-9
8703,0,0,1,0,-1
8704,0,0,68,0,-68
8705,0,0,1,0,-1
8706,0,0,34,0,-34
8707,1,1,1526,2335,809
8708,1,1,572,1761,1189
8709,1,1,663,1295,632
8710,1,1,216,1251,1035
8711,1,1,394,1263,869
8712,1,1,395,1306,911
8713,1,1,364,1584,1220
8714,1,0,94,0,-94
8715,1,0,54,0,-54
8716,0,0,16,0,-16
8717,1,1,360,1913,1553
8718,1,1,1020,1300,280
8719,1,1,139,1225,1086
8720,1,0,101,0,-101
8721,0,0,39,0,-39
8722,1,1,290,1494,1204
8723,1,0,29,0,-29
8724,1,0,2,0,-2
8725,1,1,730,1870,1140
8726,0,0,31,0,-31
8727,1,0,45,0,-45
8728,1,0,66,0,-66
8729,0,0,6,0,-6
8730,1,0,10,0,-10
8731,1,1,840,1241,401
8732,1,1,98,1209,1111
8733,0,0,110,0,-110
8734,0,0,8,0,-8
8735,1,1,494,1510,1016
8736,0,0,13,0,-13
8737,0,0,122,0,-122
8738,1,1,99,1396,1297
8739,1,0,20,0,-20
8740,0,0,5,0,-5
8741,1,0,70,0,-70
8742,1,1,113,1547,1434
8743,1,0,79,0,-79
8744,1,0,4,0,-4
8745,1,0,131,0,-131
8746,0,0,104,0,-104
8747,1,1,56,1490,1434
8748,1,1,1309,1612,303
8749,1,1,166,1824,1658
8750,1,1,1267,1828,561
8751,1,1,1276,1286,10
8752,1,0,38,0,-38
8753,1,1,141,1373,1232
8754,0,0,4,0,-4
8755,1,0,0,0,0
8756,1,0,58,0,-58
8757,0,0,37,0,-37
8758,1,0,114,0,-114
8759,1,1,337,1746,1409
8760,0,0,39,0,-39
8761,1,1,387,2564,2177
8762,0,0,26,0,-26
8763,1,0,92,0,-92
8764,1,1,419,1324,905
8765,1,1,79,1257,1178
8766,1,1,323,2058,1735
8767,1,1,157,1618,1461
8768,1,0,62,0,-62
8769,0,0,26,0,-26
8770,0,0,63,0,-63
8771,1,0,74,0,-74
8772,1,0,99,0,-99
8773,1,0,44,0,-44
8774,0,0,35,0,-35
8775,1,0,8,0,-8
8776,1,0,72,0,-72
8777,1,0,12,0,-12
8778,1,1,58,1245,1187
8779,0,0,9,0,-9
8780,0,0,165,0,-165
8781,1,0,55,0,-55
8782,0,0,58,0,-58
8783,1,1,117,1572,1455
8784,1,0,20,0,-20
8785,1,0,144,0,-144
8786,0,0,74,0,-74
8787,0,0,94,0,-94
8788,1,1,297,1579,1282
8789,1,1,262,1385,1123
8790,1,1,93,1207,1114
8791,1,1,142,1982,1840
8792,1,0,5,0,-5
8793,1,0,29,0,-29
8794,0,0,17,0,-17
8795,1,1,76,1431,1355
8796,1,1,127,1277,1150
8797,0,0,86,0,-86
8798,0,0,73,0,-73
8799,0,0,3,0,-3
8800,1,1,254,4804,4550
8801,1,0,9,0,-9
8802,1,0,7,0,-7
8803,0,0,95,0,-95
8804,1,1,135,1624,1489
8805,0,0,26,0,-26
8806,1,0,28,0,-28
8807,0,0,14,0,-14
8808,0,0,5,0,-5
8809,1,1,131,1262,1131
8810,1,1,697,1305,608
8811,1,1,64,1937,1873
8812,0,0,23,0,-23
8813,0,0,0,0,0
8814,0,0,59,0,-59
8815,1,0,66,0,-66
8816,0,0,78,0,-78
8817,1,0,53,0,-53
8818,1,1,113,1623,1510
8819,0,0,18,0,-18
8820,1,0,26,0,-26
8821,1,1,106,1348,1242
8822,0,0,22,0,-22
8823,1,1,580,1692,1112
8824,1,1,30,1486,1456
8825,1,0,40,0,-40
8826,1,1,962,2849,1887
8827,1,0,36,0,-36
8828,0,0,94,0,-94
8829,0,0,48,0,-48
8830,1,0,1,0,-1
8831,1,1,260,3829,3569
8832,1,1,328,1215,887
8833,1,0,13,0,-13
8834,1,1,552,1288,736
8835,1,0,8,0,-8
8836,1,0,39,0,-39
8837,0,0,15,0,-15
8838,0,0,7,0,-7
8839,1,0,14,0,-14
8840,1,1,602,1305,703
8841,0,0,119,0,-119
8842,1,1,62,1381,1319
8843,1,0,23,0,-23
8844,1,0,17,0,-17
8845,1,1,501,1312,811
8846,1,1,486,1756,1270
8847,1,0,88,0,-88
8848,1,0,4,0,-4
8849,0,0,15,0,-15
8850,1,1,2331,1386,-945
8851,1,1,345,3116,2771
8852,0,0,41,0,-41
8853,1,0,12,0,-12
8854,1,0,38,0,-38
8855,1,1,506,1415,909
8856,0,0,4,0,-4
8857,1,0,156,0,-156
8858,1,1,1202,1415,213
8859,0,0,12,0,-12
8860,1,0,27,0,-27
8861,1,0,288,0,-288
8862,0,0,16,0,-16
8863,1,0,3,0,-3
8864,0,0,67,0,-67
8865,1,0,33,0,-33
8866,1,0,37,0,-37
8867,1,1,644,1335,691
8868,1,0,74,0,-74
8869,1,1,774,1472,698
8870,0,0,15,0,-15
8871,1,1,752,1367,615
8872,1,1,353,2248,1895
8873,0,0,107,0,-107
8874,1,1,3019,1427,-1592
8875,0,0,22,0,-22
8876,1,0,22,0,-22
8877,0,0,34,0,-34
8878,1,0,35,0,-35
8879,0,0,13,0,-13
8880,0,0,34,0,-34
8881,1,1,438,2201,1763
8882,1,1,279,1298,1019
8883,0,0,7,0,-7
8884,1,1,486,1703,1217
8885,0,0,49,0,-49
8886,1,1,506,1291,785
8887,1,0,50,0,-50
8888,0,0,44,0,-44
8889,1,0,106,0,-106
8890,1,1,445,1361,916
8891,0,0,18,0,-18
8892,0,0,2,0,-2
8893,0,0,16,0,-16
8894,1,1,296,1949,1653
8895,0,0,9,0,-9
8896,0,0,32,0,-32
8897,1,0,18,0,-18
8898,1,1,182,1220,1038
8899,0,0,79,0,-79
8900,0,0,3,0,-3
8901,1,0,111,0,-111
8902,0,0,7,0,-7
8903,0,0,12,0,-12
8904,1,0,42,0,-42
8905,0,0,44,0,-44
8906,1,0,37,0,-37
8907,0,0,3,0,-3
8908,1,0,83,0,-83
8909,1,1,161,1288,1127
8910,0,0,12,0,-12
8911,1,0,130,0,-130
8912,0,0,63,0,-63
8913,0,0,17,0,-17
8914,0,0,40,0,-40
8915,1,1,624,2231,1607
8916,1,1,636,1865,1229
8917,0,0,61,0,-61
8918,0,0,22,0,-22
8919,1,0,14,0,-14
8920,0,0,100,0,-100
8921,1,1,446,1335,889
8922,0,0,36,0,-36
8923,0,0,88,0,-88
8924,0,0,74,0,-74
8925,0,0,6,0,-6
8926,1,1,28,1528,1500
8927,1,0,31,0,-31
8928,1,0,74,0,-74
8929,0,0,77,0,-77
8930,0,0,70,0,-70
8931,0,0,46,0,-46
8932,1,0,45,0,-45
8933,0,0,31,0,-31
8934,1,1,2166,1300,-866
8935,0,0,114,0,-114
8936,1,0,10,0,-10
8937,1,1,56,1917,1861
8938,0,0,225,0,-225
8939,1,1,186,1600,1414
8940,1,1,100,1226,1126
8941,1,1,197,1640,1443
8942,0,0,57,0,-57
8943,1,0,4,0,-4
8944,0,0,68,0,-68
8945,1,1,60,2820,2760
8946,1,1,312,1438,1126
8947,0,0,11,0,-11
8948,1,0,102,0,-102
8949,1,0,3,0,-3
8950,0,0,116,0,-116
8951,1,0,20,0,-20
8952,0,0,62,0,-62
8953,1,0,57,0,-57
8954,1,1,124,1821,1697
8955,0,0,18,0,-18
8956,1,1,650,1241,591
8957,0,0,1,0,-1
8958,0,0,11,0,-11
8959,1,0,3,0,-3
8960,1,1,742,1284,542
8961,1,0,0,0,0
8962,0,0,92,0,-92
8963,0,0,35,0,-35
8964,0,0,48,0,-48
8965,0,0,9,0,-9
8966,1,0,19,0,-19
8967,1,0,55,0,-55
8968,1,1,477,1615,1138
8969,0,0,116,0,-116
8970,0,0,9,0,-9
8971,0,0,16,0,-16
8972,1,0,11,0,-11
8973,1,0,32,0,-32
8974,1,0,25,0,-25
8975,1,1,462,1534,1072
8976,1,1,247,1264,1017
8977,1,1,218,1204,986
8978,1,1,626,1571,945
8979,1,1,411,1673,1262
8980,1,0,9,0,-9
8981,1,0,6,0,-6
8982,1,0,95,0,-95
8983,1,0,43,0,-43
8984,1,1,455,1226,771
8985,1,0,2,0,-2
8986,1,0,6,0,-6
8987,0,0,52,0,-52
8988,1,0,57,0,-57
8989,1,1,669,1619,950
8990,1,1,320,1222,902
8991,1,0,34,0,-34
8992,0,0,22,0,-22
8993,0,0,44,0,-44
8994,1,0,23,0,-23
8995,1,1,263,2255,1992
8996,0,0,31,0,-31
8997,0,0,26,0,-26
8998,0,0,79,0,-79
8999,0,0,50,0,-50
9000,0,0,38,0,-38
9001,1,1,616,1273,657
9002,0,0,12,0,-12
9003,1,1,182,1275,1093
9004,0,0,21,0,-21
9005,1,0,5,0,-5
9006,1,1,213,1730,1517
9007,0,0,55,0,-55
9008,0,0,0,0,0
9009,0,0,115,0,-115
9010,1,0,42,0,-42
9011,1,0,68,0,-68
9012,1,1,66,1225,1159
9013,1,0,5,0,-5
9014,1,0,29,0,-29
9015,0,0,41,0,-41
9016,0,0,12,0,-12
9017,1,1,87,2784,2697
9018,0,0,25,0,-25
9019,0,0,80,0,-80
9020,1,1,815,1417,602
9021,1,1,54,1218,1164
9022,0,0,108,0,-108
9023,0,0,10,0,-10
9024,1,0,73,0,-73
9025,0,0,33,0,-33
9026,1,0,82,0,-82
9027,0,0,32,0,-32
9028,0,0,52,0,-52
9029,1,1,249,1390,1141
9030,1,1,90,1418,1328
9031,0,0,5,0,-5
9032,0,0,15,0,-15
9033,1,1,1405,1207,-198
9034,1,0,7,0,-7
9035,0,0,145,0,-145
9036,1,1,179,1915,1736
9037,0,0,3,0,-3
9038,1,0,8,0,-8
9039,0,0,66,0,-66
9040,1,1,696,1332,636
9041,0,0,73,0,-73
9042,1,0,33,0,-33
9043,0,0,23,0,-23
9044,1,0,66,0,-66
9045,0,0,27,0,-27
9046,0,0,9,0,-9
9047,1,0,63,0,-63
9048,0,0,27,0,-27
9049,0,0,1,0,-1
9050,1,1,689,1536,847
9051,1,1,17,1277,1260
9052,1,1,241,1272,1031
9053,1,0,20,0,-20
9054,1,0,6,0,-6
9055,0,0,19,0,-19
9056,1,0,3,0,-3
9057,1,0,46,0,-46
9058,1,1,107,1509,1402
9059,1,0,17,0,-17
9060,1,0,359,0,-359
9061,1,0,41,0,-41
9062,0,0,9,0,-9
9063,1,1,715,1299,584
9064,1,0,22,0,-22
9065,0,0,73,0,-73
9066,1,1,359,1705,1346
9067,0,0,29,0,-29
9068,1,1,13,1757,1744
9069,0,0,75,0,-75
9070,0,0,81,0,-81
9071,1,1,238,1553,1315
9072,0,0,68,0,-68
9073,0,0,1,0,-1
9074,0,0,96,0,-96
9075,0,0,60,0,-60
9076,1,0,169,0,-169
9077,1,1,613,2131,1518
9078,0,0,33,0,-33
9079,0,0,147,0,-147
9080,1,1,1909,1313,-596
9081,0,0,12,0,-12
9082,1,1,1126,1209,83
9083,1,1,1489,1403,-86
9084,1,0,28,0,-28
9085,1,1,810,2188,1378
9086,0,0,117,0,-117
9087,0,0,141,0,-141
9088,0,0,39,0,-39
9089,1,1,264,1507,1243
9090,1,1,1214,1230,16
9091,1,1,487,1384,897
9092,1,1,206,3868,3662
9093,0,0,51,0,-51
9094,0,0,2,0,-2
9095,1,1,29,1890,1861
9096,0,0,18,0,-18
9097,1,1,611,1369,758
9098,0,0,132,0,-132
9099,0,0,11,0,-11
9100,1,0,8,0,-8
9101,1,1,353,1341,988
9102,0,0,46,0,-46
9103,1,1,266,1365,1099
9104,1,1,444,1485,1041
9105,1,0,57,0,-57
9106,1,0,5,0,-5
9107,1,1,17,1518,1501
9108,0,0,74,0,-74
9109,1,1,27,1326,1299
9110,0,0,16,0,-16
9111,1,0,22,0,-22
9112,0,0,59,0,-59
9113,0,0,16,0,-16
9114,1,0,5,0,-5
9115,0,0,11,0,-11
9116,1,0,59,0,-59
9117,1,0,48,0,-48
9118,1,0,18,0,-18
9119,1,0,7,0,-7
9120,1,0,1,0,-1
9121,0,0,146,0,-146
9122,1,1,646,2305,1659
9123,1,1,600,1495,895
9124,0,0,35,0,-35
9125,0,0,90,0,-90
9126,0,0,112,0,-112
9127,1,1,614,1222,608
9128,1,0,18,0,-18
9129,1,0,56,0,-56
9130,1,1,785,1275,490
9131,1,0,8,0,-8
9132,0,0,116,0,-116
9133,1,1,435,1645,1210
9134,1,0,210,0,-210
9135,1,1,40,1541,1501
9136,1,0,55,0,-55
9137,0,0,19,0,-19
9138,0,0,75,0,-75
9139,0,0,65,0,-65
9140,1,1,1529,1209,-320
9141,1,1,14,1216,1202
9142,0,0,164,0,-164
9143,0,0,74,0,-74
9144,0,0,13,0,-13
9145,1,1,70,1205,1135
9146,1,0,83,0,-83
9147,0,0,25,0,-25
9148,0,0,67,0,-67
9149,0,0,12,0,-12
9150,1,0,34,0,-34
9151,1,1,471,1254,783
9152,0,0,17,0,-17
9153,1,1,138,1616,1478
9154,1,1,1298,1686,388
9155,0,0,1,0,-1
9156,1,0,206,0,-206
9157,1,1,289,1705,1416
9158,1,1,1448,1260,-188
9159,1,1,568,1498,930
9160,1,0,73,0,-73
9161,1,1,214,1911,1697
9162,1,0,30,0,-30
9163,1,0,13,0,-13
9164,0,0,21,0,-21
9165,0,0,24,0,-24
9166,0,0,22,0,-22
9167,0,0,50,0,-50
9168,0,0,53,0,-53
9169,0,0,0,0,0
9170,1,0,9,0,-9
9171,0,0,11,0,-11
9172,0,0,28,0,-28
9173,1,1,485,1404,919
9174,1,1,842,1546,704
9175,0,0,184,0,-184
9176,1,1,762,1292,530
9177,1,1,82,1475,1393
9178,1,0,126,0,-126
9179,0,0,24,0,-24
9180,1,1,670,1289,619
9181,1,0,111,0,-111
9182,1,1,1270,1200,-70
9183,0,0,20,0,-20
9184,1,0,9,0,-9
9185,1,0,49,0,-49
9186,1,1,338,1359,1021
9187,0,0,75,0,-75
9188,0,0,13,0,-13
9189,0,0,85,0,-85
9190,1,0,49,0,-49
9191,0,0,17,0,-17
9192,1,0,86,0,-86
9193,1,0,86,0,-86
9194,0,0,35,0,-35
9195,1,0,16,0,-16
9196,1,1,81,1404,1323
9197,1,1,263,1451,1188
9198,0,0,65,0,-65
9199,0,0,73,0,-73
9200,1,1,435,1747,1312
9201,1,0,127,0,-127
9202,0,0,0,0,0
9203,1,0,39,0,-39
9204,0,0,40,0,-40
9205,1,0,110,0,-110
9206,1,0,13,0,-13
9207,1,1,687,1500,813
9208,1,0,74,0,-74
9209,0,0,10,0,-10
9210,1,0,17,0,-17
9211,1,1,1048,1575,527
9212,0,0,89,0,-89
9213,1,1,1020,1780,760
9214,0,0,16,0,-16
9215,1,1,1492,1233,-259
9216,1,0,5,0,-5
9217,1,0,1,0,-1
9218,1,0,27,0,-27
9219,0,0,21,0,-21
9220,0,0,33,0,-33
9221,0,0,18,0,-18
9222,0,0,2,0,-2
9223,1,0,8,0,-8
9224,0,0,10,0,-10
9225,1,1,97,1227,1130
9226,1,1,326,1422,1096
9227,1,1,288,1548,1260
9228,1,1,126,1427,1301
9229,1,0,0,0,0
9230,0,0,24,0,-24
9231,1,0,99,0,-99
9232,0,0,60,0,-60
9233,1,1,287,1205,918
9234,1,1,1227,1868,641
9235,1,0,2,0,-2
9236,1,0,111,0,-111
9237,0,0,72,0,-72
9238,0,0,15,0,-15
9239,1,1,21,1412,1391
9240,1,1,738,2205,1467
9241,0,0,75,0,-75
9242,1,0,31,0,-31
9243,1,1,1409,1444,35
9244,1,0,58,0,-58
9245,1,0,129,0,-129
9246,0,0,45,0,-45
9247,0,0,9,0,-9
9248,0,0,50,0,-50
9249,1,1,106,1471,1365
9250,0,0,132,0,-132
9251,1,0,96,0,-96
9252,1,0,161,0,-161
9253,1,0,3,0,-3
9254,1,0,39,0,-39
9255,0,0,88,0,-88
9256,0,0,13,0,-13
9257,0,0,12,0,-12
9258,0,0,63,0,-63
9259,1,1,580,1339,759
9260,0,0,63,0,-63
9261,1,1,815,1458,643
9262,1,0,30,0,-30
9263,1,1,161,1943,1782
9264,1,1,53,1231,1178
9265,1,1,636,1687,1051
9266,0,0,16,0,-16
9267,1,0,36,0,-36
9268,1,0,30,0,-30
9269,0,0,74,0,-74
9270,1,0,40,0,-40
9271,1,1,159,1264,1105
9272,0,0,122,0,-122
9273,1,0,7,0,-7
9274,1,0,33,0,-33
9275,0,0,84,0,-84
9276,1,0,26,0,-26
9277,1,1,222,1509,1287
9278,0,0,39,0,-39
9279,0,0,144,0,-144
9280,1,1,1166,2590,1424
9281,0,0,143,0,-143
9282,0,0,9,0,-9
9283,0,0,52,0,-52
9284,1,1,170,1251,1081
9285,0,0,44,0,-44
9286,1,0,106,0,-106
9287,1,1,1102,1868,766
9288,1,1,268,1275,1007
9289,0,0,43,0,-43
9290,0,0,5,0,-5
9291,0,0,112,0,-112
9292,1,0,32,0,-32
9293,0,0,2,0,-2
9294,1,0,77,0,-77
9295,0,0,25,0,-25
9296,1,1,844,2220,1376
9297,0,0,164,0,-164
9298,0,0,13,0,-13
9299,0,0,84,0,-84
9300,1,0,103,0,-103
9301,1,1,992,1535,543
9302,1,0,112,0,-112
9303,0,0,0,0,0
9304,1,0,82,0,-82
9305,1,1,454,1417,963
9306,0,0,10,0,-10
9307,0,0,2,0,-2
9308,0,0,25,0,-25
9309,1,0,21,0,-21
9310,1,0,161,0,-161
9311,0,0,0,0,0
9312,0,0,12,0,-12
9313,1,1,233,1482,1249
9314,0,0,58,0,-58
9315,0,0,73,0,-73
9316,1,1,224,1394,1170
9317,0,0,139,0,-139
9318,1,0,23,0,-23
9319,0,0,57,0,-57
9320,1,0,69,0,-69
9321,0,0,20,0,-20
9322,0,0,60,0,-60
9323,1,0,17,0,-17
9324,0,0,3,0,-3
9325,0,0,84,0,-84
9326,0,0,35,0,-35
9327,1,1,42,1370,1328
9328,1,0,22,0,-22
9329,1,1,256,1701,1445
9330,1,1,463,1658,1195
9331,0,0,12,0,-12
9332,1,0,15,0,-15
9333,1,0,6,0,-6
9334,1,1,2284,1592,-692
9335,1,0,21,0,-21
9336,0,0,12,0,-12
9337,0,0,101,0,-101
9338,0,0,18,0,-18
9339,1,0,27,0,-27
9340,0,0,74,0,-74
9341,1,0,9,0,-9
9342,0,0,12,0,-12
9343,1,1,387,1413,1026
9344,1,1,107,2570,2463
9345,1,1,345,1536,1191
9346,0,0,12,0,-12
9347,0,0,29,0,-29
9348,1,0,23,0,-23
9349,1,0,16,0,-16
9350,1,1,738,1217,479
9351,0,0,1,0,-1
9352,1,1,384,1267,883
9353,1,1,1539,1803,264
9354,0,0,3,0,-3
9355,1,0,15,0,-15
9356,1,1,664,1215,551
9357,0,0,92,0,-92
9358,0,0,9,0,-9
9359,1,0,17,0,-17
9360,0,0,36,0,-36
9361,0,0,12,0,-12
9362,0,0,73,0,-73
9363,1,0,52,0,-52
9364,1,0,0,0,0
9365,1,1,218,1271,1053
9366,1,0,60,0,-60
9367,1,1,1165,1780,615
9368,0,0,212,0,-212
9369,0,0,11,0,-11
9370,0,0,119,0,-119
9371,0,0,55,0,-55
9372,0,0,50,0,-50
9373,1,1,384,1630,1246
9374,1,0,99,0,-99
9375,0,0,65,0,-65
9376,0,0,9,0,-9
9377,0,0,59,0,-59
9378,1,1,182,1451,1269
9379,1,1,1034,1899,865
9380,1,1,835,1439,604
9381,1,0,33,0,-33
9382,0,0,65,0,-65
9383,1,0,23,0,-23
9384,0,0,152,0,-152
9385,1,0,69,0,-69
9386,1,0,8,0,-8
9387,1,0,0,0,0
9388,0,0,40,0,-40
9389,1,0,36,0,-36
9390,0,0,7,0,-7
9391,0,0,61,0,-61
9392,1,0,135,0,-135
9393,1,1,427,2041,1614
9394,1,0,125,0,-125
9395,1,1,872,1250,378
9396,1,1,355,1298,943
9397,0,0,11,0,-11
9398,0,0,81,0,-81
9399,1,1,357,1832,1475
9400,1,0,27,0,-27
9401,1,1,632,1209,577
9402,1,1,77,1298,1221
9403,1,1,693,1408,715
9404,0,0,1,0,-1
9405,1,0,43,0,-43
9406,1,0,129,0,-129
9407,1,1,1943,1646,-297
9408,1,0,11,0,-11
9409,0,0,0,0,0
9410,0,0,147,0,-147
9411,0,0,257,0,-257
9412,1,1,702,1996,1294
9413,1,0,59,0,-59
9414,1,0,3,0,-3
9415,0,0,9,0,-9
9416,0,0,59,0,-59
9417,1,1,267,2460,2193
9418,0,0,9,0,-9
9419,1,1,91,1354,1263
9420,1,0,229,0,-229
9421,0,0,23,0,-23
9422,1,1,1368,1882,514
9423,0,0,4,0,-4
9424,1,0,84,0,-84
9425,0,0,5,0,-5
9426,0,0,9,0,-9
9427,1,1,473,3352,2879
9428,0,0,16,0,-16
9429,1,0,110,0,-110
9430,1,1,748,1242,494
9431,1,1,103,1207,1104
9432,1,1,1005,1242,237
9433,1,0,130,0,-130
9434,1,0,2,0,-2
9435,0,0,56,0,-56
9436,0,0,99,0,-99
9437,1,1,206,1216,1010
9438,0,0,98,0,-98
9439,1,1,2482,1457,-1025
9440,0,0,7,0,-7
9441,0,0,19,0,-19
9442,1,0,11,0,-11
9443,0,0,195,0,-195
9444,0,0,65,0,-65
9445,1,1,305,1484,1179
9446,1,0,57,0,-57
9447,0,0,20,0,-20
9448,0,0,22,0,-22
9449,1,1,25,1274,1249
9450,0,0,22,0,-22
9451,1,0,19,0,-19
9452,1,1,289,1483,1194
9453,1,1,152,1600,1448
9454,1,1,179,2336,2157
9455,0,0,144,0,-144
9456,0,0,1,0,-1
9457,0,0,157,0,-157
9458,0,0,74,0,-74
9459,0,0,43,0,-43
9460,1,0,13,0,-13
9461,0,0,43,0,-43
9462,1,0,30,0,-30
9463,0,0,14,0,-14
9464,1,1,57,1472,1415
9465,1,0,24,0,-24
9466,0,0,31,0,-31
9467,0,0,9,0,-9
9468,1,0,4,0,-4
9469,0,0,78,0,-78
9470,1,1,1836,1721,-115
9471,1,0,27,0,-27
9472,1,0,6,0,-6
9473,1,1,357,1480,1123
9474,0,0,5,0,-5
9475,0,0,27,0,-27
9476,1,0,219,0,-219
9477,0,0,22,0,-22
9478,0,0,34,0,-34
9479,0,0,68,0,-68
9480,0,0,20,0,-20
9481,0,0,35,0,-35
9482,0,0,69,0,-69
9483,1,0,17,0,-17
9484,1,1,224,1625,1401
9485,1,0,12,0,-12
9486,0,0,168,0,-168
9487,1,1,990,2360,1370
9488,0,0,137,0,-137
9489,0,0,44,0,-44
9490,1,1,251,1754,1503
9491,1,1,433,1471,1038
9492,0,0,11,0,-11
9493,1,1,112,1697,1585
9494,1,1,424,1401,977
9495,1,0,23,0,-23
9496,1,0,30,0,-30
9497,1,0,56,0,-56
9498,0,0,22,0,-22
9499,1,0,52,0,-52
9500,0,0,37,0,-37
9501,0,0,113,0,-113
9502,1,0,57,0,-57
9503,0,0,48,0,-48
9504,1,0,39,0,-39
9505,1,1,291,2018,1727
9506,0,0,78,0,-78
9507,0,0,51,0,-51
9508,1,0,14,0,-14
9509,1,1,198,1672,1474
9510,0,0,73,0,-73
9511,1,0,47,0,-47
9512,1,1,204,1871,1667
9513,0,0,60,0,-60
9514,1,0,23,0,-23
9515,0,0,0,0,0
9516,0,0,73,0,-73
9517,1,0,37,0,-37
9518,1,0,10,0,-10
9519,0,0,84,0,-84
9520,1,0,5,0,-5
9521,1,1,659,1589,930
9522,1,0,105,0,-105
9523,1,0,39,0,-39
9524,1,0,186,0,-186
9525,1,1,698,1519,821
9526,0,0,40,0,-40
9527,1,0,18,0,-18
9528,0,0,38,0,-38
9529,1,1,979,1361,382
9530,0,0,19,0,-19
9531,1,1,274,1480,1206
9532,0,0,76,0,-76
9533,0,0,116,0,-116
9534,0,0,87,0,-87
9535,1,0,8,0,-8
9536,1,1,281,1295,1014
9537,1,1,106,1485,1379
9538,1,0,57,0,-57
9539,1,0,57,0,-57
9540,0,0,41,0,-41
9541,1,1,456,1442,986
9542,1,1,976,2530,1554
9543,1,1,288,1675,1387
9544,0,0,10,0,-10
9545,0,0,15,0,-15
9546,1,1,286,1551,1265
9547,0,0,11,0,-11
9548,0,0,24,0,-24
9549,0,0,30,0,-30
9550,0,0,159,0,-159
9551,1,0,69,0,-69
9552,1,1,1664,1819,155
9553,0,0,5,0,-5
9554,1,0,18,0,-18
9555,1,0,137,0,-137
9556,1,1,1583,1757,174
9557,1,1,139,1999,1860
9558,0,0,101,0,-101
9559,0,0,121,0,-121
9560,0,0,0,0,0
9561,0,0,4,0,-4
9562,0,0,138,0,-138
9563,0,0,44,0,-44
9564,0,0,14,0,-14
9565,1,0,77,0,-77
9566,1,1,555,1243,688
9567,0,0,20,0,-20
9568,1,1,308,1712,1404
9569,1,1,1072,1421,349
9570,0,0,182,0,-182
9571,0,0,11,0,-11
9572,0,0,1,0,-1
9573,1,1,211,1413,1202
9574,0,0,90,0,-90
9575,0,0,65,0,-65
9576,0,0,52,0,-52
9577,1,1,390,1444,1054
9578,1,0,59,0,-59
9579,1,1,300,1569,1269
9580,1,1,157,1955,1798
9581,1,1,208,1212,1004
9582,1,0,23,0,-23
9583,0,0,7,0,-7
9584,1,0,31,0,-31
9585,0,0,4,0,-4
9586,1,1,494,1401,907
9587,0,0,199,0,-199
9588,1,1,384,1790,1406
9589,0,0,50,0,-50
9590,0,0,9,0,-9
9591,1,0,12,0,-12
9592,0,0,32,0,-32
9593,1,1,751,1338,587
9594,1,0,0,0,0
9595,0,0,20,0,-20
9596,1,0,68,0,-68
9597,1,1,922,1313,391
9598,1,0,85,0,-85
9599,0,0,14,0,-14
9600,1,0,55,0,-55
9601,1,0,70,0,-70
9602,1,0,62,0,-62
9603,1,1,90,1251,1161
9604,0,0,57,0,-57
9605,1,0,15,0,-15
9606,0,0,54,0,-54
9607,1,1,328,1886,1558
9608,1,1,264,1473,1209
9609,1,0,10,0,-10
9610,0,0,18,0,-18
9611,0,0,47,0,-47
9612,0,0,19,0,-19
9613,0,0,43,0,-43
9614,1,1,1157,1296,139
9615,0,0,48,0,-48
9616,1,1,553,1889,1336
9617,0,0,11,0,-11
9618,0,0,9,0,-9
9619,1,0,24,0,-24
9620,1,0,26,0,-26
9621,0,0,21,0,-21
9622,1,1,558,1239,681
9623,1,1,1542,1777,235
9624,0,0,166,0,-166
9625,0,0,31,0,-31
9626,0,0,19,0,-19
9627,1,0,111,0,-111
9628,1,0,23,0,-23
9629,0,0,136,0,-136
9630,1,1,288,1213,925
9631,1,0,1,0,-1
9632,0,0,78,0,-78
9633,1,0,20,0,-20
9634,1,1,167,1419,1252
9635,0,0,244,0,-244
9636,0,0,55,0,-55
9637,0,0,8,0,-8
9638,0,0,5,0,-5
9639,1,1,1771,1288,-483
9640,1,0,144,0,-144
9641,1,0,28,0,-28
9642,0,0,30,0,-30
9643,1,1,145,1240,1095
9644,1,0,59,0,-59
9645,1,1,77,1632,1555
9646,1,0,24,0,-24
9647,1,1,101,1515,1414
9648,0,0,37,0,-37
9649,1,1,232,2431,2199
9650,0,0,23,0,-23
9651,1,0,15,0,-15
9652,1,0,230,0,-230
9653,0,0,10,0,-10
9654,1,1,1667,1383,-284
9655,1,0,5,0,-5
9656,1,1,824,1774,950
9657,0,0,7,0,-7
9658,1,0,4,0,-4
9659,0,0,9,0,-9
9660,1,0,43,0,-43
9661,0,0,63,0,-63
9662,1,1,59,1456,1397
9663,0,0,16,0,-16
9664,1,1,24,1327,1303
9665,0,0,78,0,-78
9666,0,0,70,0,-70
9667,1,1,1704,1449,-255
9668,1,1,731,1474,743
9669,0,0,52,0,-52
9670,0,0,128,0,-128
9671,1,1,1084,1892,808
9672,0,0,8,0,-8
9673,0,0,18,0,-18
9674,1,0,22,0,-22
9675,0,0,293,0,-293
9676,0,0,11,0,-11
9677,1,1,223,1333,1110
9678,1,0,17,0,-17
9679,0,0,43,0,-43
9680,0,0,16,0,-16
9681,1,0,108,0,-108
9682,1,1,569,1306,737
9683,1,0,2,0,-2
9684,0,0,31,0,-31
9685,0,0,42,0,-42
9686,1,0,61,0,-61
9687,0,0,60,0,-60
9688,1,1,602,1266,664
9689,0,0,15,0,-15
9690,0,0,18,0,-18
9691,1,1,178,1404,1226
9692,0,0,35,0,-35
9693,0,0,29,0,-29
9694,0,0,235,0,-235
9695,1,1,154,1378,1224
9696,1,0,5,0,-5
9697,1,1,671,2056,1385
9698,1,0,8,0,-8
9699,0,0,97,0,-97
9700,1,0,4,0,-4
9701,1,1,506,1218,712
9702,1,0,18,0,-18
9703,1,1,576,1229,653
9704,1,0,3,0,-3
9705,0,0,38,0,-38
9706,1,1,786,1546,760
9707,1,1,195,1254,1059
9708,1,1,492,1576,1084
9709,0,0,95,0,-95
9710,0,0,90,0,-90
9711,0,0,41,0,-41
9712,1,0,157,0,-157
9713,1,1,387,1262,875
9714,0,0,3,0,-3
9715,1,1,1294,1260,-34
9716,1,0,71,0,-71
9717,1,0,1,0,-1
9718,0,0,3,0,-3
9719,0,0,18,0,-18
9720,1,0,10,0,-10
9721,1,1,1072,1339,267
9722,0,0,26,0,-26
9723,1,1,377,1235,858
9724,1,1,332,1990,1658
9725,0,0,2,0,-2
9726,1,1,35,1269,1234
9727,1,1,641,1386,745
9728,1,0,49,0,-49
9729,1,1,826,1517,691
9730,0,0,126,0,-126
9731,0,0,132,0,-132
9732,1,1,458,1373,915
9733,1,1,178,1752,1574
9734,0,0,34,0,-34
9735,0,0,43,0,-43
9736,0,0,42,0,-42
9737,0,0,75,0,-75
9738,0,0,101,0,-101
9739,0,0,31,0,-31
9740,0,0,10,0,-10
9741,1,1,1131,1289,158
9742,1,0,203,0,-203
9743,0,0,210,0,-210
9744,0,0,40,0,-40
9745,1,0,39,0,-39
9746,0,0,31,0,-31
9747,1,0,12,0,-12
9748,0,0,19,0,-19
9749,1,1,135,1338,1203
9750,1,1,24,2617,2593
9751,1,0,220,0,-220
9752,1,1,465,1272,807
9753,1,0,174,0,-174
9754,1,1,119,1212,1093
9755,1,1,737,1241,504
9756,1,0,3,0,-3
9757,1,1,405,1393,988
9758,0,0,14,0,-14
9759,1,1,83,2631,2548
9760,1,0,54,0,-54
9761,1,1,711,1580,869
9762,1,0,117,0,-117
9763,1,1,265,1366,1101
9764,0,0,87,0,-87
9765,0,0,54,0,-54
9766,1,0,57,0,-57
9767,0,0,79,0,-79
9768,0,0,59,0,-59
9769,0,0,42,0,-42
9770,1,1,434,2480,2046
9771,0,0,42,0,-42
9772,1,1,81,1326,1245
9773,1,1,1961,1356,-605
9774,1,0,55,0,-55
9775,1,0,3,0,-3
9776,1,0,6,0,-6
9777,1,0,22,0,-22
9778,0,0,113,0,-113
9779,0,0,18,0,-18
9780,1,0,55,0,-55
9781,1,1,34,1403,1369
9782,0,0,24,0,-24
9783,0,0,46,0,-46
9784,0,0,41,0,-41
9785,0,0,10,0,-10
9786,1,1,189,1252,1063
9787,1,0,22,0,-22
9788,1,1,805,1437,632
9789,0,0,6,0,-6
9790,1,1,397,2338,1941
9791,1,0,24,0,-24
9792,1,0,33,0,-33
9793,1,1,1940,1339,-601
9794,0,0,32,0,-32
9795,0,0,11,0,-11
9796,1,1,400,1248,848
9797,0,0,72,0,-72
9798,1,1,342,1474,1132
9799,0,0,1,0,-1
9800,1,0,22,0,-22
9801,1,1,2058,1309,-749
9802,0,0,13,0,-13
9803,1,0,46,0,-46
9804,1,0,4,0,-4
9805,0,0,34,0,-34
9806,1,0,14,0,-14
9807,1,1,1136,1271,135
9808,1,1,528,2426,1898
9809,0,0,36,0,-36
9810,0,0,14,0,-14
9811,1,1,263,1242,979
9812,1,0,5,0,-5
9813,0,0,111,0,-111
9814,0,0,115,0,-115
9815,1,0,35,0,-35
9816,0,0,102,0,-102
9817,1,0,43,0,-43
9818,1,1,174,1618,1444
9819,1,1,204,1241,1037
9820,0,0,17,0,-17
9821,1,1,1251,1482,231
9822,1,1,822,1254,432
9823,1,0,23,0,-23
9824,1,0,28,0,-28
9825,0,0,20,0,-20
9826,0,0,18,0,-18
9827,1,1,434,1511,1077
9828,0,0,9,0,-9
9829,0,0,148,0,-148
9830,0,0,48,0,-48
9831,1,1,1156,1466,310
9832,1,0,105,0,-105
9833,0,0,84,0,-84
9834,0,0,20,0,-20
9835,1,0,95,0,-95
9836,0,0,28,0,-28
9837,1,1,260,1970,1710
9838,1,0,53,0,-53
9839,0,0,9,0,-9
9840,1,0,26,0,-26
9841,1,1,136,1225,1089
9842,1,1,150,1472,1322
9843,1,1,432,1253,821
9844,0,0,37,0,-37
9845,1,0,24,0,-24
9846,1,0,23,0,-23
9847,1,0,123,0,-123
9848,1,1,417,1265,848
9849,1,0,21,0,-21
9850,0,0,29,0,-29
9851,0,0,37,0,-37
9852,1,1,1100,1240,140
9853,1,0,41,0,-41
9854,1,1,123,2096,1973
9855,1,1,650,1410,760
9856,1,1,213,1455,1242
9857,0,0,83,0,-83
9858,1,0,2,0,-2
9859,0,0,19,0,-19
9860,0,0,8,0,-8
9861,0,0,56,0,-56
9862,1,1,69,1278,1209
9863,1,1,1147,1572,425
9864,1,1,218,1401,1183
9865,1,1,567,1603,1036
9866,1,1,2093,1202,-891
9867,0,0,11,0,-11
9868,1,1,735,1606,871
9869,1,1,787,1420,633
9870,1,0,12,0,-12
9871,0,0,116,0,-116
9872,1,0,34,0,-34
9873,1,1,568,2332,1764
9874,1,0,65,0,-65
9875,1,1,1006,1216,210
9876,0,0,22,0,-22
9877,1,1,305,1210,905
9878,0,0,38,0,-38
9879,0,0,15,0,-15
9880,1,0,65,0,-65
9881,1,0,55,0,-55
9882,1,0,21,0,-21
9883,0,0,24,0,-24
9884,0,0,9,0,-9
9885,0,0,114,0,-114
9886,1,0,23,0,-23
9887,0,0,19,0,-19
9888,1,0,24,0,-24
9889,1,1,303,1592,1289
9890,1,0,109,0,-109
9891,0,0,14,0,-14
9892,1,1,582,1270,688
9893,0,0,127,0,-127
9894,1,1,507,1510,1003
9895,0,0,10,0,-10
9896,0,0,36,0,-36
9897,1,1,6,1584,1578
9898,0,0,10,0,-10
9899,1,0,5,0,-5
9900,0,0,6,0,-6
9901,1,1,297,1653,1356
9902,0,0,37,0,-37
9903,1,0,20,0,-20
9904,1,1,106,1529,1423
9905,1,1,488,1574,1086
9906,0,0,25,0,-25
9907,1,1,273,1663,1390
9908,1,0,54,0,-54
9909,0,0,131,0,-131
9910,1,0,5,0,-5
9911,0,0,47,0,-47
9912,0,0,0,0,0
9913,0,0,6,0,-6
9914,0,0,103,0,-103
9915,0,0,110,0,-110
9916,1,0,127,0,-127
9917,0,0,16,0,-16
9918,1,0,132,0,-132
9919,1,1,111,1699,1588
9920,1,1,247,2636,2389
9921,0,0,22,0,-22
9922,1,0,20,0,-20
9923,1,0,17,0,-17
9924,1,0,106,0,-106
9925,0,0,12,0,-12
9926,1,0,234,0,-234
9927,1,1,24,1283,1259
9928,1,1,312,1450,1138
9929,1,0,15,0,-15
9930,1,1,740,1329,589
9931,1,1,112,2004,1892
9932,1,0,77,0,-77
9933,1,0,7,0,-7
9934,0,0,10,0,-10
9935,0,0,91,0,-91
9936,1,0,134,0,-134
9937,1,1,1078,1588,510
9938,1,1,1615,1768,153
9939,0,0,35,0,-35
9940,1,1,184,1271,1087
9941,0,0,197,0,-197
9942,1,0,83,0,-83
9943,1,1,80,1240,1160
9944,1,0,28,0,-28
9945,0,0,22,0,-22
9946,0,0,59,0,-59
9947,0,0,11,0,-11
9948,0,0,59,0,-59
9949,1,1,1122,1513,391
9950,1,1,16,3701,3685
9951,1,1,818,2549,1731
9952,0,0,13,0,-13
9953,1,1,487,1352,865
9954,1,1,60,1863,1803
9955,1,0,89,0,-89
9956,0,0,3,0,-3
9957,0,0,28,0,-28
9958,1,0,31,0,-31
9959,0,0,20,0,-20
9960,1,0,28,0,-28
9961,1,0,22,0,-22
9962,1,0,44,0,-44
9963,1,1,361,1566,1205
9964,1,0,11,0,-11
9965,0,0,69,0,-69
9966,0,0,76,0,-76
9967,0,0,19,0,-19
9968,1,0,27,0,-27
9969,1,0,44,0,-44
9970,1,1,388,1264,876
9971,1,1,22,1901,1879
9972,1,0,8,0,-8
9973,0,0,50,0,-50
9974,0,0,38,0,-38
9975,0,0,144,0,-144
9976,0,0,85,0,-85
9977,1,1,94,1471,1377
9978,0,0,21,0,-21
9979,0,0,49,0,-49
9980,0,0,81,0,-81
9981,1,0,3,0,-3
9982,1,0,123,0,-123
9983,0,0,87,0,-87
9984,1,1,776,1791,1015
9985,0,0,30,0,-30
9986,1,1,162,1829,1667
9987,0,0,2,0,-2
9988,0,0,13,0,-13
9989,1,0,18,0,-18
9990,1,0,63,0,-63
9991,0,0,26,0,-26
9992,1,1,538,1570,1032
9993,0,0,110,0,-110
9994,1,0,12,0,-12
9995,0,0,66,0,-66
9996,1,0,13,0,-13
9997,0,0,106,0,-106
9998,0,0,7,0,-7
9999,1,1,70,1220,1150
10000,1,1,2335,1376,-959
10001,0,0,43,0,-43
10002,0,0,3,0,-3
10003,1,1,92,1207,1115
10004,1,0,66,0,-66
10005,0,0,91,0,-91
10006,0,0,2,0,-2
10007,0,0,36,0,-36
10008,0,0,30,0,-30
10009,0,0,140,0,-140
10010,0,0,36,0,-36
10011,1,1,295,1411,1116
10012,0,0,12,0,-12
10013,1,0,17,0,-17
10014,0,0,141,0,-141
10015,1,0,58,0,-58
10016,1,0,34,0,-34
10017,1,0,226,0,-226
10018,0,0,44,0,-44
10019,1,1,262,1628,1366
10020,1,1,30,1865,1835
10021,0,0,35,0,-35
10022,1,1,254,1900,1646
10023,1,0,38,0,-38
10024,0,0,206,0,-206
10025,1,0,1,0,-1
10026,0,0,148,0,-148
10027,0,0,167,0,-167
10028,0,0,47,0,-47
10029,0,0,53,0,-53
10030,1,0,14,0,-14
10031,0,0,80,0,-80
10032,0,0,30,0,-30
10033,1,1,264,1524,1260
10034,0,0,75,0,-75
10035,1,0,2,0,-2
10036,1,1,123,1266,1143
10037,0,0,19,0,-19
10038,0,0,95,0,-95
10039,1,1,208,1217,1009
10040,1,1,1131,1423,292
10041,1,0,10,0,-10
10042,1,1,1685,1393,-292
10043,1,1,410,1253,843
10044,1,0,10,0,-10
10045,0,0,14,0,-14
10046,1,0,61,0,-61
10047,1,1,47,1854,1807
10048,1,0,19,0,-19
10049,1,0,51,0,-51
10050,1,0,0,0,0
10051,0,0,57,0,-57
10052,1,1,135,1509,1374
10053,0,0,53,0,-53
10054,0,0,41,0,-41
10055,0,0,23,0,-23
10056,1,0,6,0,-6
10057,1,1,680,3292,2612
10058,0,0,50,0,-50
10059,0,0,120,0,-120
10060,0,0,81,0,-81
10061,1,0,37,0,-37
10062,0,0,6,0,-6
10063,0,0,38,0,-38
10064,1,0,32,0,-32
10065,1,1,167,1514,1347
10066,0,0,20,0,-20
10067,0,0,85,0,-85
10068,0,0,10,0,-10
10069,1,0,2,0,-2
10070,1,0,136,0,-136
10071,0,0,3,0,-3
10072,0,0,26,0,-26
10073,0,0,0,0,0
10074,0,0,48,0,-48
10075,1,0,50,0,-50
10076,0,0,16,0,-16
10077,1,0,12,0,-12
10078,1,0,0,0,0
10079,0,0,63,0,-63
10080,0,0,14,0,-14
10081,1,1,1881,1449,-432
10082,1,0,92,0,-92
10083,1,0,117,0,-117
10084,0,0,13,0,-13
10085,1,1,369,1685,1316
10086,1,0,23,0,-23
10087,1,0,82,0,-82
10088,0,0,54,0,-54
10089,1,0,6,0,-6
10090,1,0,8,0,-8
10091,0,0,88,0,-88
10092,1,0,37,0,-37
10093,0,0,75,0,-75
10094,1,1,619,2183,1564
10095,1,0,9,0,-9
10096,1,1,559,1324,765
10097,1,0,10,0,-10
10098,0,0,4,0,-4
10099,1,0,138,0,-138
10100,1,1,677,1481,804
10101,0,0,11,0,-11
10102,1,1,320,1283,963
10103,1,1,159,1288,1129
10104,1,1,12,1216,1204
10105,1,0,7,0,-7
10106,0,0,33,0,-33
10107,1,0,7,0,-7
10108,1,1,692,1273,581
10109,1,1,806,1364,558
10110,1,0,41,0,-41
10111,1,1,325,1605,1280
10112,0,0,41,0,-41
10113,0,0,5,0,-5
10114,1,0,160,0,-160
10115,0,0,2,0,-2
10116,0,0,12,0,-12
10117,0,0,33,0,-33
10118,1,1,469,1502,1033
10119,1,0,174,0,-174
10120,0,0,38,0,-38
10121,1,1,968,1703,735
10122,1,1,842,1299,457
10123,1,1,2336,2031,-305
10124,1,1,810,1486,676
10125,0,0,31,0,-31
10126,0,0,92,0,-92
10127,1,0,53,0,-53
10128,0,0,16,0,-16
10129,1,1,407,1397,990
10130,1,1,407,1261,854
10131,0,0,28,0,-28
10132,1,0,42,0,-42
10133,1,1,136,1368,1232
10134,0,0,26,0,-26
10135,0,0,77,0,-77
10136,0,0,38,0,-38
10137,0,0,17,0,-17
10138,0,0,58,0,-58
10139,1,1,142,2195,2053
10140,1,1,197,1687,1490
10141,1,0,56,0,-56
10142,1,0,21,0,-21
10143,1,0,46,0,-46
10144,1,1,62,1282,1220
10145,1,1,1318,1353,35
10146,1,1,538,1408,870
10147,0,0,7,0,-7
10148,1,1,653,1806,1153
10149,0,0,2,0,-2
10150,0,0,0,0,0
10151,0,0,40,0,-40
10152,1,0,57,0,-57
10153,0,0,18,0,-18
10154,0,0,3,0,-3
10155,0,0,33,0,-33
10156,1,0,56,0,-56
10157,1,1,472,1915,1443
10158,0,0,39,0,-39
10159,0,0,56,0,-56
10160,0,0,18,0,-18
10161,0,0,30,0,-30
10162,1,0,14,0,-14
10163,0,0,21,0,-21
10164,1,1,319,2005,1686
10165,0,0,1,0,-1
10166,0,0,109,0,-109
10167,1,0,7,0,-7
10168,1,0,17,0,-17
10169,1,1,274,1962,1688
10170,1,1,215,2564,2349
10171,0,0,136,0,-136
10172,1,1,632,1257,625
10173,1,0,134,0,-134
10174,1,0,9,0,-9
10175,1,1,66,1392,1326
10176,0,0,1,0,-1
10177,0,0,2,0,-2
10178,0,0,32,0,-32
10179,0,0,3,0,-3
10180,0,0,1,0,-1
10181,1,1,439,1608,1169
10182,1,1,1472,1497,25
10183,1,0,26,0,-26
10184,0,0,3,0,-3
10185,0,0,38,0,-38
10186,0,0,159,0,-159
10187,0,0,124,0,-124
10188,1,0,56,0,-56
10189,0,0,98,0,-98
10190,0,0,105,0,-105
10191,0,0,124,0,-124
10192,1,0,1,0,-1
10193,1,0,22,0,-22
10194,1,1,232,1625,1393
10195,0,0,2,0,-2
10196,1,0,2,0,-2
10197,1,1,119,1274,1155
10198,1,0,110,0,-110
10199,0,0,5,0,-5
10200,1,1,560,1224,664
10201,1,0,276,0,-276
10202,1,1,385,2113,1728
10203,1,0,62,0,-62
10204,0,0,46,0,-46
10205,1,1,14,1376,1362
10206,1,1,194,1297,1103
10207,0,0,147,0,-147
10208,1,0,0,0,0
10209,1,1,263,1224,961
10210,0,0,199,0,-199
10211,0,0,30,0,-30
10212,1,0,1,0,-1
10213,1,0,133,0,-133
10214,1,1,95,1406,1311
10215,0,0,17,0,-17
10216,1,0,13,0,-13
10217,1,1,557,2022,1465
10218,0,0,22,0,-22
10219,1,0,74,0,-74
10220,1,1,888,3981,3093
10221,0,0,23,0,-23
10222,1,0,261,0,-261
10223,1,0,119,0,-119
10224,1,0,62,0,-62
10225,0,0,66,0,-66
10226,1,1,874,2175,1301
10227,0,0,9,0,-9
10228,1,0,34,0,-34
10229,1,1,134,1368,1234
10230,0,0,32,0,-32
10231,0,0,180,0,-180
10232,0,0,109,0,-109
10233,0,0,21,0,-21
10234,0,0,4,0,-4
10235,1,0,41,0,-41
10236,0,0,102,0,-102
10237,0,0,26,0,-26
10238,0,0,13,0,-13
10239,1,0,113,0,-113
10240,1,1,432,1401,969
10241,1,1,165,1285,1120
10242,0,0,47,0,-47
10243,1,0,69,0,-69
10244,1,0,44,0,-44
10245,1,0,5,0,-5
10246,0,0,68,0,-68
10247,0,0,3,0,-3
10248,1,1,782,1789,1007
10249,0,0,52,0,-52
10250,1,0,21,0,-21
10251,1,1,314,1249,935
10252,0,0,35,0,-35
10253,0,0,35,0,-35
10254,1,0,31,0,-31
10255,1,1,689,2313,1624
10256,1,0,17,0,-17
10257,1,1,7,1297,1290
10258,1,0,25,0,-25
10259,1,1,655,1861,1206
10260,0,0,7,0,-7
10261,0,0,133,0,-133
10262,1,0,40,0,-40
10263,0,0,51,0,-51
10264,0,0,1,0,-1
10265,1,0,13,0,-13
10266,1,0,72,0,-72
10267,1,1,373,1503,1130
10268,0,0,11,0,-11
10269,1,1,2014,1531,-483
10270,1,0,33,0,-33
10271,1,0,2,0,-2
10272,0,0,185,0,-185
10273,1,1,611,1400,789
10274,0,0,90,0,-90
10275,1,0,60,0,-60
10276,1,0,11,0,-11
10277,0,0,123,0,-123
10278,1,0,16,0,-16
10279,1,0,31,0,-31
10280,1,1,139,1224,1085
10281,1,1,88,1270,1182
10282,1,0,36,0,-36
10283,0,0,88,0,-88
10284,0,0,100,0,-100
10285,0,0,132,0,-132
10286,1,0,196,0,-196
10287,0,0,36,0,-36
10288,1,1,57,1251,1194
10289,0,0,125,0,-125
10290,1,0,147,0,-147
10291,1,1,1057,1593,536
10292,0,0,13,0,-13
10293,1,0,93,0,-93
10294,1,1,213,2333,2120
10295,1,0,12,0,-12
10296,0,0,73,0,-73
10297,0,0,18,0,-18
10298,1,1,28,1269,1241
10299,0,0,54,0,-54
10300,1,1,323,1706,1383
10301,1,1,412,1310,898
10302,1,1,164,1267,1103
10303,0,0,55,0,-55
10304,0,0,31,0,-31
10305,1,0,92,0,-92
10306,0,0,1,0,-1
10307,1,1,734,1923,1189
10308,1,0,9,0,-9
10309,1,0,19,0,-19
10310,0,0,75,0,-75
10311,0,0,11,0,-11
10312,1,0,17,0,-17
10313,0,0,26,0,-26
10314,1,1,323,2985,2662
10315,1,1,501,1855,1354
10316,1,0,34,0,-34
10317,1,0,20,0,-20
10318,1,0,161,0,-161
10319,1,1,12,2126,2114
10320,0,0,38,0,-38
10321,0,0,29,0,-29
10322,1,0,15,0,-15
10323,0,0,67,0,-67
10324,1,0,108,0,-108
10325,1,0,40,0,-40
10326,0,0,61,0,-61
10327,1,0,47,0,-47
10328,0,0,13,0,-13
10329,0,0,81,0,-81
10330,0,0,7,0,-7
10331,1,1,987,1583,596
10332,0,0,20,0,-20
10333,0,0,46,0,-46
10334,0,0,26,0,-26
10335,0,0,34,0,-34
10336,0,0,4,0,-4
10337,0,0,7,0,-7
10338,0,0,45,0,-45
10339,1,0,8,0,-8
10340,1,0,19,0,-19
10341,0,0,10,0,-10
10342,0,0,48,0,-48
10343,1,0,6,0,-6
10344,1,1,10,1482,1472
10345,0,0,0,0,0
10346,0,0,7,0,-7
10347,1,1,166,1394,1228
10348,1,0,20,0,-20
10349,1,0,62,0,-62
10350,1,0,25,0,-25
10351,1,0,51,0,-51
10352,1,0,81,0,-81
10353,1,0,60,0,-60
10354,1,1,276,1216,940
10355,0,0,33,0,-33
10356,1,1,402,1467,1065
10357,0,0,59,0,-59
10358,1,0,32,0,-32
10359,1,1,1163,1206,43
10360,0,0,79,0,-79
10361,0,0,3,0,-3
10362,1,1,259,1262,1003
10363,1,1,247,1209,962
10364,1,0,54,0,-54
10365,0,0,1,0,-1
10366,1,1,31,1336,1305
10367,0,0,7,0,-7
10368,0,0,8,0,-8
10369,0,0,71,0,-71
10370,1,1,119,1565,1446
10371,0,0,240,0,-240
10372,1,1,141,2217,2076
10373,0,0,13,0,-13
10374,1,1,719,1720,1001
10375,0,0,11,0,-11
10376,1,0,64,0,-64
10377,1,1,237,1254,1017
10378,1,1,318,1294,976
10379,1,1,195,2326,2131
10380,0,0,15,0,-15
10381,1,0,67,0,-67
10382,1,1,478,1562,1084
10383,0,0,1,0,-1
10384,0,0,206,0,-206
10385,0,0,8,0,-8
10386,1,1,129,1536,1407
10387,0,0,39,0,-39
10388,1,0,12,0,-12
10389,1,0,19,0,-19
10390,1,0,0,0,0
10391,1,0,4,0,-4
10392,1,0,51,0,-51
10393,1,0,142,0,-142
10394,1,1,441,3108,2667
10395,0,0,0,0,0
10396,0,0,15,0,-15
10397,0,0,141,0,-141
10398,1,0,49,0,-49
10399,1,0,16,0,-16
10400,1,0,16,0,-16
10401,0,0,39,0,-39
10402,0,0,72,0,-72
10403,1,1,459,1270,811
10404,0,0,8,0,-8
10405,1,1,509,1633,1124
10406,1,1,104,1213,1109
10407,1,1,159,1329,1170
10408,1,1,1529,1407,-122
10409,1,1,636,1327,691
10410,1,1,126,1356,1230
10411,0,0,21,0,-21
10412,1,0,3,0,-3
10413,1,0,12,0,-12
10414,1,0,45,0,-45
10415,0,0,3,0,-3
10416,0,0,139,0,-139
10417,1,0,54,0,-54
10418,1,1,216,1251,1035
10419,1,0,237,0,-237
10420,1,0,3,0,-3
10421,1,1,48,1685,1637
10422,1,1,349,1366,1017
10423,1,1,280,1246,966
10424,0,0,8,0,-8
10425,0,0,27,0,-27
10426,1,1,582,1304,722
10427,1,0,21,0,-21
10428,1,1,495,1381,886
10429,1,1,225,1815,1590
10430,1,1,370,1216,846
10431,0,0,34,0,-34
10432,0,0,11,0,-11
10433,0,0,30,0,-30
10434,1,1,327,1646,1319
10435,0,0,10,0,-10
10436,0,0,16,0,-16
10437,0,0,1,0,-1
10438,1,1,345,1720,1375
10439,0,0,15,0,-15
10440,1,1,526,1623,1097
10441,0,0,23,0,-23
10442,1,0,20,0,-20
10443,1,1,797,1320,523
10444,1,0,75,0,-75
10445,1,1,82,1271,1189
10446,1,0,170,0,-170
10447,1,0,89,0,-89
10448,0,0,81,0,-81
10449,1,0,23,0,-23
10450,1,0,1,0,-1
10451,1,1,357,1758,1401
10452,1,0,17,0,-17
10453,0,0,34,0,-34
10454,0,0,1,0,-1
10455,0,0,20,0,-20
10456,1,0,51,0,-51
10457,1,0,122,0,-122
10458,1,0,8,0,-8
10459,1,1,407,1605,1198
10460,1,1,304,1448,1144
10461,1,0,4,0,-4
10462,0,0,35,0,-35
10463,0,0,11,0,-11
10464,1,0,52,0,-52
10465,1,1,562,1250,688
10466,1,1,200,1425,1225
10467,0,0,24,0,-24
10468,1,1,1142,1496,354
10469,1,1,53,1200,1147
10470,1,0,25,0,-25
10471,1,1,1548,1331,-217
10472,0,0,32,0,-32
10473,1,1,277,1607,1330
10474,0,0,3,0,-3
10475,1,0,207,0,-207
10476,1,1,90,1349,1259
10477,1,1,59,1385,1326
10478,0,0,41,0,-41
10479,1,0,60,0,-60
10480,1,1,378,1410,1032
10481,1,1,182,3052,2870
10482,0,0,61,0,-61
10483,1,0,13,0,-13
10484,1,0,103,0,-103
10485,0,0,3,0,-3
10486,0,0,20,0,-20
10487,0,0,50,0,-50
10488,0,0,35,0,-35
10489,1,0,222,0,-222
10490,1,1,278,1286,1008
10491,1,0,56,0,-56
10492,1,0,28,0,-28
10493,1,0,13,0,-13
10494,0,0,9,0,-9
10495,1,0,75,0,-75
10496,0,0,7,0,-7
10497,0,0,50,0,-50
10498,0,0,22,0,-22
10499,0,0,117,0,-117
10500,1,1,540,1216,676
10501,1,1,339,1357,1018
10502,0,0,11,0,-11
10503,0,0,38,0,-38
10504,1,0,262,0,-262
10505,1,1,1410,1432,22
10506,0,0,94,0,-94
10507,0,0,2,0,-2
10508,0,0,5,0,-5
10509,0,0,102,0,-102
10510,1,1,311,2068,1757
10511,0,0,54,0,-54
10512,0,0,1,0,-1
10513,1,0,1,0,-1
10514,0,0,158,0,-158
10515,0,0,15,0,-15
10516,1,1,482,1207,725
10517,1,0,28,0,-28
10518,1,0,23,0,-23
10519,0,0,68,0,-68
10520,1,1,283,1437,1154
10521,1,1,1087,1246,159
10522,1,0,12,0,-12
10523,1,1,443,1201,758
10524,1,0,63,0,-63
10525,0,0,20,0,-20
10526,0,0,4,0,-4
10527,1,0,25,0,-25
10528,1,1,708,2273,1565
10529,0,0,32,0,-32
10530,0,0,154,0,-154
10531,1,1,1477,1438,-39
10532,1,0,9,0,-9
10533,0,0,28,0,-28
10534,1,1,501,1745,1244
10535,1,1,1184,1731,547
10536,0,0,0,0,0
10537,0,0,45,0,-45
10538,1,1,782,1256,474
10539,1,1,419,1315,896
10540,1,0,67,0,-67
10541,0,0,6,0,-6
10542,1,0,19,0,-19
10543,1,0,0,0,0
10544,1,1,269,1433,1164
10545,1,0,101,0,-101
10546,1,1,300,1601,1301
10547,0,0,205,0,-205
10548,1,0,232,0,-232
10549,0,0,6,0,-6
10550,0,0,23,0,-23
10551,1,0,123,0,-123
10552,1,1,33,1216,1183
10553,1,0,36,0,-36
10554,1,0,8,0,-8
10555,0,0,87,0,-87
10556,1,0,273,0,-273
10557,0,0,60,0,-60
10558,0,0,28,0,-28
10559,0,0,26,0,-26
10560,1,0,19,0,-19
10561,0,0,1,0,-1
10562,1,1,72,1456,1384
10563,0,0,63,0,-63
10564,0,0,12,0,-12
10565,0,0,24,0,-24
10566,0,0,88,0,-88
10567,0,0,39,0,-39
10568,0,0,38,0,-38
10569,1,1,1150,1341,191
10570,1,0,18,0,-18
10571,1,0,126,0,-126
10572,0,0,101,0,-101
10573,1,0,76,0,-76
10574,1,0,52,0,-52
10575,1,0,57,0,-57
10576,1,1,4,1264,1260
10577,0,0,123,0,-123
10578,1,0,50,0,-50
10579,0,0,27,0,-27
10580,0,0,25,0,-25
10581,1,0,2,0,-2
10582,1,0,34,0,-34
10583,1,0,242,0,-242
10584,1,0,4,0,-4
10585,0,0,60,0,-60
10586,1,1,71,1320,1249
10587,0,0,8,0,-8
10588,0,0,54,0,-54
10589,1,1,1093,1287,194
10590,1,1,334,1392,1058
10591,1,1,934,1511,577
10592,1,0,47,0,-47
10593,0,0,154,0,-154
10594,1,1,1103,1523,420
10595,1,0,25,0,-25
10596,1,1,195,1552,1357
10597,1,0,76,0,-76
10598,1,0,48,0,-48
10599,1,0,6,0,-6
10600,0,0,21,0,-21
10601,1,0,69,0,-69
10602,1,0,38,0,-38
10603,1,1,172,1289,1117
10604,0,0,41,0,-41
10605,1,0,21,0,-21
10606,1,0,1,0,-1
10607,1,1,331,1294,963
10608,1,0,24,0,-24
10609,1,1,1150,1268,118
10610,1,1,410,1425,1015
10611,1,1,340,1765,1425
10612,0,0,21,0,-21
10613,0,0,95,0,-95
10614,0,0,80,0,-80
10615,0,0,24,0,-24
10616,0,0,20,0,-20
10617,1,1,490,1442,952
10618,1,0,21,0,-21
10619,0,0,27,0,-27
10620,0,0,128,0,-128
10621,0,0,41,0,-41
10622,1,0,7,0,-7
10623,1,1,930,1213,283
10624,0,0,29,0,-29
10625,0,0,35,0,-35
10626,0,0,24,0,-24
10627,0,0,94,0,-94
10628,1,1,892,1561,669
10629,1,1,348,1414,1066
10630,0,0,7,0,-7
10631,1,1,219,1201,982
10632,1,1,238,1401,1163
10633,1,1,60,1226,1166
10634,0,0,45,0,-45
10635,0,0,33,0,-33
10636,0,0,70,0,-70
10637,1,0,51,0,-51
10638,1,0,22,0,-22
10639,0,0,39,0,-39
10640,0,0,89,0,-89
10641,1,0,216,0,-216
10642,1,1,311,1385,1074
10643,1,0,77,0,-77
10644,1,1,360,1324,964
10645,1,1,331,1201,870
10646,1,1,814,1654,840
10647,0,0,4,0,-4
10648,0,0,64,0,-64
10649,1,1,579,1384,805
10650,1,1,271,1327,1056
10651,1,0,53,0,-53
10652,1,1,329,1663,1334
10653,1,0,27,0,-27
10654,1,1,969,1589,620
10655,0,0,92,0,-92
10656,0,0,19,0,-19
10657,1,0,45,0,-45
10658,1,0,14,0,-14
10659,0,0,55,0,-55
10660,1,0,2,0,-2
10661,0,0,36,0,-36
10662,1,0,54,0,-54
10663,1,0,9,0,-9
10664,0,0,57,0,-57
10665,1,1,498,1308,810
10666,0,0,11,0,-11
10667,0,0,36,0,-36
10668,0,0,1,0,-1
10669,0,0,117,0,-117
10670,1,0,150,0,-150
10671,1,0,44,0,-44
10672,1,1,202,1267,1065
10673,1,0,15,0,-15
10674,1,0,16,0,-16
10675,1,1,340,1203,863
10676,0,0,22,0,-22
10677,1,0,25,0,-25
10678,1,0,65,0,-65
10679,1,0,22,0,-22
10680,1,1,747,1321,574
10681,1,1,439,1771,1332
10682,0,0,9,0,-9
10683,0,0,48,0,-48
10684,1,0,44,0,-44
10685,1,0,3,0,-3
10686,1,1,572,1339,767
10687,1,0,15,0,-15
10688,1,1,171,1701,1530
10689,0,0,5,0,-5
10690,1,0,47,0,-47
10691,1,0,28,0,-28
10692,0,0,19,0,-19
10693,1,1,231,1585,1354
10694,1,0,76,0,-76
10695,0,0,19,0,-19
10696,1,1,418,1421,1003
10697,0,0,37,0,-37
10698,0,0,76,0,-76
10699,1,1,1004,1818,814
10700,1,1,718,1750,1032
10701,1,0,26,0,-26
10702,1,1,86,1217,1131
10703,1,0,20,0,-20
10704,1,1,936,1244,308
10705,1,0,4,0,-4
10706,1,0,116,0,-116
10707,0,0,23,0,-23
10708,0,0,65,0,-65
10709,1,0,51,0,-51
10710,1,1,1107,2049,942
10711,1,1,1669,1654,-15
10712,0,0,8,0,-8
10713,1,1,395,1570,1175
10714,0,0,53,0,-53
10715,1,0,7,0,-7
10716,0,0,60,0,-60
10717,1,0,143,0,-143
10718,1,1,75,1291,1216
10719,1,1,286,1790,1504
10720,1,0,91,0,-91
10721,0,0,35,0,-35
10722,0,0,20,0,-20
10723,1,1,184,1240,1056
10724,1,1,315,1307,992
10725,0,0,102,0,-102
10726,0,0,6,0,-6
10727,1,1,645,1297,652
10728,0,0,77,0,-77
10729,1,1,629,1260,631
10730,0,0,32,0,-32
10731,0,0,23,0,-23
10732,1,0,96,0,-96
10733,1,0,43,0,-43
10734,1,1,94,1300,1206
10735,1,0,45,0,-45
10736,1,1,366,1790,1424
10737,1,0,73,0,-73
10738,1,0,23,0,-23
10739,1,1,1065,2453,1388
10740,1,1,68,1393,1325
10741,1,1,517,2403,1886
10742,1,0,39,0,-39
10743,0,0,48,0,-48
10744,1,1,1968,2277,309
10745,0,0,0,0,0
10746,1,0,18,0,-18
10747,1,1,820,1266,446
10748,0,0,192,0,-192
10749,0,0,38,0,-38
10750,0,0,0,0,0
10751,0,0,96,0,-96
10752,1,0,47,0,-47
10753,1,1,62,1320,1258
10754,1,1,483,1806,1323
10755,0,0,59,0,-59
10756,0,0,8,0,-8
10757,1,1,991,1278,287
10758,0,0,185,0,-185
10759,1,0,104,0,-104
10760,1,1,236,1436,1200
10761,1,1,111,1606,1495
10762,1,0,57,0,-57
10763,1,0,10,0,-10
10764,1,1,462,1295,833
10765,1,0,10,0,-10
10766,1,0,24,0,-24
10767,1,0,5,0,-5
10768,0,0,42,0,-42
10769,0,0,25,0,-25
10770,0,0,12,0,-12
10771,1,0,38,0,-38
10772,1,0,86,0,-86
10773,0,0,6,0,-6
10774,1,1,2805,1607,-1198
10775,1,1,199,2101,1902
10776,1,0,31,0,-31
10777,1,0,36,0,-36
10778,0,0,75,0,-75
10779,1,0,42,0,-42
10780,1,0,75,0,-75
10781,1,1,427,1361,934
10782,1,1,1245,2624,1379
10783,0,0,116,0,-116
10784,1,0,116,0,-116
10785,0,0,19,0,-19
10786,1,1,221,2612,2391
10787,0,0,39,0,-39
10788,1,0,68,0,-68
10789,1,1,716,1566,850
10790,1,1,395,2573,2178
10791,1,0,46,0,-46
10792,1,0,120,0,-120
10793,0,0,6,0,-6
10794,1,1,98,2093,1995
10795,0,0,25,0,-25
10796,1,1,570,1485,915
10797,0,0,4,0,-4
10798,1,0,120,0,-120
10799,1,0,40,0,-40
10800,1,1,123,1226,1103
10801,1,0,5,0,-5
10802,1,0,11,0,-11
10803,1,1,66,2019,1953
10804,1,0,56,0,-56
10805,1,0,2,0,-2
10806,0,0,220,0,-220
10807,0,0,12,0,-12
10808,0,0,128,0,-128
10809,0,0,85,0,-85
10810,1,0,25,0,-25
10811,1,0,169,0,-169
10812,1,1,352,1244,892
10813,1,1,762,1317,555
10814,1,0,40,0,-40
10815,1,0,7,0,-7
10816,1,0,22,0,-22
10817,1,1,236,1494,1258
10818,1,0,13,0,-13
10819,1,1,193,1389,1196
10820,1,1,138,1265,1127
10821,1,0,82,0,-82
10822,1,0,23,0,-23
10823,1,0,44,0,-44
10824,0,0,4,0,-4
10825,0,0,73,0,-73
10826,1,1,44,1348,1304
10827,0,0,2,0,-2
10828,1,1,381,1310,929
10829,1,1,235,4045,3810
10830,1,1,32,1231,1199
10831,0,0,42,0,-42
10832,1,0,99,0,-99
10833,1,1,448,2358,1910
10834,0,0,0,0,0
10835,1,1,398,1448,1050
10836,1,1,422,3001,2579
10837,0,0,14,0,-14
10838,1,1,121,1781,1660
10839,1,0,75,0,-75
10840,0,0,15,0,-15
10841,1,1,85,1669,1584
10842,1,1,679,1265,586
10843,1,1,421,1630,1209
10844,1,1,647,1337,690
10845,1,1,32,1360,1328
10846,0,0,1,0,-1
10847,1,1,320,1336,1016
10848,0,0,121,0,-121
10849,0,0,28,0,-28
10850,1,0,135,0,-135
10851,1,0,68,0,-68
10852,0,0,154,0,-154
10853,1,0,51,0,-51
10854,0,0,92,0,-92
10855,1,0,97,0,-97
10856,0,0,136,0,-136
10857,0,0,18,0,-18
10858,0,0,4,0,-4
10859,1,0,7,0,-7
10860,0,0,48,0,-48
10861,1,1,267,2388,2121
10862,1,1,342,2291,1949
10863,1,1,1218,1213,-5
10864,0,0,20,0,-20
10865,0,0,51,0,-51
10866,1,0,62,0,-62
10867,0,0,72,0,-72
10868,1,1,599,1397,798
10869,0,0,41,0,-41
10870,0,0,88,0,-88
10871,0,0,21,0,-21
10872,0,0,176,0,-176
10873,0,0,20,0,-20
10874,0,0,22,0,-22
10875,0,0,38,0,-38
10876,0,0,76,0,-76
10877,1,0,105,0,-105
10878,0,0,24,0,-24
10879,1,1,740,3756,3016
10880,0,0,125,0,-125
10881,1,0,5,0,-5
10882,1,1,455,2935,2480
10883,1,1,34,1415,1381
10884,1,0,44,0,-44
10885,0,0,11,0,-11
10886,1,0,34,0,-34
10887,0,0,15,0,-15
10888,1,0,74,0,-74
10889,0,0,10,0,-10
10890,0,0,3,0,-3
10891,1,0,13,0,-13
10892,1,0,75,0,-75
10893,0,0,18,0,-18
10894,1,0,26,0,-26
10895,1,1,505,1266,761
10896,1,1,301,2364,2063
10897,1,1,1741,1290,-451
10898,0,0,25,0,-25
10899,1,0,125,0,-125
10900,1,0,14,0,-14
10901,1,1,220,1219,999
10902,1,0,13,0,-13
10903,1,0,191,0,-191
10904,1,1,1533,1567,34
10905,0,0,14,0,-14
10906,1,0,24,0,-24
10907,0,0,25,0,-25
10908,1,1,876,1289,413
10909,0,0,89,0,-89
10910,1,0,2,0,-2
10911,0,0,41,0,-41
10912,0,0,5,0,-5
10913,1,1,300,1549,1249
10914,1,0,21,0,-21
10915,1,0,33,0,-33
10916,1,0,58,0,-58
10917,1,0,2,0,-2
10918,0,0,44,0,-44
10919,1,0,2,0,-2
10920,1,0,19,0,-19
10921,1,1,502,1935,1433
10922,1,0,10,0,-10
10923,0,0,33,0,-33
10924,0,0,16,0,-16
10925,1,1,750,1470,720
10926,1,0,15,0,-15
10927,0,0,167,0,-167
10928,1,1,426,1351,925
10929,1,1,543,1330,787
10930,0,0,33,0,-33
10931,1,0,3,0,-3
10932,0,0,9,0,-9
10933,0,0,65,0,-65
10934,1,1,585,1360,775
10935,1,1,82,1565,1483
10936,0,0,35,0,-35
10937,0,0,67,0,-67
10938,1,1,891,2278,1387
10939,0,0,29,0,-29
10940,0,0,45,0,-45
10941,1,0,49,0,-49
10942,1,0,13,0,-13
10943,1,1,230,1451,1221
10944,0,0,24,0,-24
10945,0,0,35,0,-35
10946,1,0,107,0,-107
10947,1,0,76,0,-76
10948,0,0,27,0,-27
10949,1,1,647,1461,814
10950,1,1,522,2027,1505
10951,0,0,51,0,-51
10952,0,0,20,0,-20
10953,1,1,472,1628,1156
10954,1,0,37,0,-37
10955,1,0,7,0,-7
10956,0,0,0,0,0
10957,0,0,14,0,-14
10958,0,0,1,0,-1
10959,0,0,58,0,-58
10960,1,1,1183,1885,702
10961,0,0,146,0,-146
10962,0,0,57,0,-57
10963,0,0,1,0,-1
10964,0,0,5,0,-5
10965,0,0,82,0,-82
10966,1,1,1275,2268,993
10967,0,0,7,0,-7
10968,0,0,75,0,-75
10969,0,0,37,0,-37
10970,0,0,10,0,-10
10971,0,0,44,0,-44
10972,1,0,57,0,-57
10973,0,0,10,0,-10
10974,1,1,78,1484,1406
10975,0,0,78,0,-78
10976,1,0,73,0,-73
10977,1,1,476,1877,1401
10978,1,0,50,0,-50
10979,1,1,113,2519,2406
10980,0,0,87,0,-87
10981,0,0,151,0,-151
10982,0,0,2,0,-2
10983,0,0,0,0,0
10984,1,0,0,0,0
10985,1,0,21,0,-21
10986,0,0,57,0,-57
10987,0,0,131,0,-131
10988,1,1,336,1836,1500
10989,1,0,49,0,-49
10990,0,0,8,0,-8
10991,0,0,94,0,-94
10992,1,1,893,1774,881
10993,0,0,56,0,-56
10994,0,0,20,0,-20
10995,0,0,139,0,-139
10996,0,0,1,0,-1
10997,0,0,6,0,-6
10998,1,0,46,0,-46
10999,0,0,230,0,-230
11000,0,0,86,0,-86
11001,0,0,143,0,-143
11002,0,0,27,0,-27
11003,1,0,5,0,-5
11004,0,0,2,0,-2
11005,1,0,5,0,-5
11006,0,0,61,0,-61
11007,1,1,364,1217,853
11008,1,0,70,0,-70
11009,1,0,103,0,-103
11010,1,0,20,0,-20
11011,0,0,7,0,-7
11012,1,0,21,0,-21
11013,0,0,67,0,-67
11014,1,1,340,1255,915
11015,0,0,11,0,-11
11016,1,1,599,1891,1292
11017,1,1,412,1703,1291
11018,0,0,200,0,-200
11019,1,1,65,1315,1250
11020,1,0,39,0,-39
11021,1,0,56,0,-56
11022,0,0,23,0,-23
11023,0,0,105,0,-105
11024,0,0,43,0,-43
11025,1,0,79,0,-79
11026,1,0,1,0,-1
11027,1,0,9,0,-9
11028,1,1,118,1301,1183
11029,0,0,127,0,-127
11030,1,1,515,1494,979
11031,0,0,81,0,-81
11032,0,0,100,0,-100
11033,0,0,56,0,-56
11034,1,1,304,1353,1049
11035,1,0,96,0,-96
11036,1,1,206,1685,1479
11037,1,0,0,0,0
11038,1,0,5,0,-5
11039,1,1,229,1601,1372
11040,1,0,8,0,-8
11041,0,0,66,0,-66
11042,1,0,33,0,-33
11043,1,1,1080,1220,140
11044,0,0,42,0,-42
11045,1,0,70,0,-70
11046,1,0,91,0,-91
11047,0,0,168,0,-168
11048,0,0,42,0,-42
11049,1,0,0,0,0
11050,1,0,187,0,-187
11051,1,0,62,0,-62
11052,0,0,30,0,-30
11053,1,1,122,1247,1125
11054,1,1,161,1432,1271
11055,1,1,261,1264,1003
11056,1,1,343,1313,970
11057,1,0,44,0,-44
11058,1,1,119,1266,1147
11059,0,0,11,0,-11
11060,0,0,61,0,-61
11061,0,0,41,0,-41
11062,0,0,11,0,-11
11063,1,0,44,0,-44
11064,0,0,6,0,-6
11065,1,0,13,0,-13
11066,0,0,17,0,-17
11067,0,0,79,0,-79
11068,0,0,112,0,-112
11069,0,0,28,0,-28
11070,0,0,147,0,-147
11071,1,0,64,0,-64
11072,1,0,38,0,-38
11073,0,0,7,0,-7
11074,1,0,109,0,-109
11075,1,1,35,1465,1430
11076,0,0,25,0,-25
11077,1,1,309,1588,1279
11078,0,0,96,0,-96
11079,0,0,1,0,-1
11080,0,0,5,0,-5
11081,1,0,16,0,-16
11082,1,0,13,0,-13
11083,1,1,465,2342,1877
11084,0,0,172,0,-172
11085,1,1,54,1564,1510
11086,0,0,2,0,-2
11087,1,0,74,0,-74
11088,1,0,19,0,-19
11089,1,0,107,0,-107
11090,0,0,25,0,-25
11091,0,0,168,0,-168
11092,1,1,81,1666,1585
11093,0,0,29,0,-29
11094,1,1,155,1394,1239
11095,1,0,25,0,-25
11096,1,0,39,0,-39
11097,0,0,61,0,-61
11098,0,0,61,0,-61
11099,1,1,217,1294,1077
11100,1,0,140,0,-140
11101,0,0,20,0,-20
11102,1,0,23,0,-23
11103,1,0,3,0,-3
11104,1,1,298,1737,1439
11105,1,0,13,0,-13
11106,1,0,83,0,-83
11107,0,0,78,0,-78
11108,0,0,17,0,-17
11109,1,1,196,1306,1110
11110,0,0,69,0,-69
11111,1,0,9,0,-9
11112,1,0,12,0,-12
11113,1,1,449,1217,768
11114,1,1,387,1608,1221
11115,1,0,188,0,-188
11116,0,0,33,0,-33
11117,0,0,13,0,-13
11118,1,1,180,1385,1205
11119,1,0,32,0,-32
11120,1,1,289,1360,1071
11121,0,0,19,0,-19
11122,0,0,12,0,-12
11123,1,1,144,1291,1147
11124,0,0,3,0,-3
11125,1,0,94,0,-94
11126,1,1,913,1574,661
11127,0,0,26,0,-26
11128,0,0,25,0,-25
11129,1,0,37,0,-37
11130,0,0,23,0,-23
11131,1,1,164,2177,2013
11132,1,1,397,2170,1773
11133,1,1,2304,2405,101
11134,1,1,205,1233,1028
11135,1,0,120,0,-120
11136,0,0,48,0,-48
11137,1,1,96,1609,1513
11138,1,0,29,0,-29
11139,1,0,36,0,-36
11140,0,0,5,0,-5
11141,1,1,80,1404,1324
11142,1,0,17,0,-17
11143,1,0,128,0,-128
11144,0,0,52,0,-52
11145,1,1,807,1481,674
11146,1,0,2,0,-2
11147,1,1,431,1256,825
11148,1,0,68,0,-68
11149,1,0,10,0,-10
11150,1,1,1078,2128,1050
11151,1,0,17,0,-17
11152,1,0,0,0,0
11153,1,0,199,0,-199
11154,1,0,49,0,-49
11155,0,0,19,0,-19
11156,0,0,52,0,-52
11157,0,0,47,0,-47
11158,0,0,37,0,-37
11159,1,1,124,1494,1370
11160,0,0,88,0,-88
11161,0,0,3,0,-3
11162,1,0,43,0,-43
11163,0,0,18,0,-18
11164,1,1,153,1581,1428
11165,1,0,55,0,-55
11166,1,0,90,0,-90
11167,0,0,115,0,-115
11168,1,0,123,0,-123
11169,1,1,122,1938,1816
11170,1,0,35,0,-35
11171,0,0,3,0,-3
11172,0,0,200,0,-200
11173,1,0,13,0,-13
11174,1,1,181,1481,1300
11175,1,1,926,3554,2628
11176,0,0,15,0,-15
11177,1,1,127,1236,1109
11178,0,0,21,0,-21
11179,0,0,53,0,-53
11180,0,0,18,0,-18
11181,1,1,375,1667,1292
11182,1,1,225,1700,1475
11183,0,0,34,0,-34
11184,1,0,2,0,-2
11185,0,0,7,0,-7
11186,1,1,393,1444,1051
11187,1,0,24,0,-24
11188,0,0,106,0,-106
11189,1,1,330,1234,904
11190,1,0,32,0,-32
11191,0,0,6,0,-6
11192,1,1,291,1422,1131
11193,1,1,139,1239,1100
11194,0,0,106,0,-106
11195,0,0,55,0,-55
11196,0,0,1,0,-1
11197,1,1,147,1402,1255
11198,1,0,42,0,-42
11199,1,1,1161,1302,141
11200,1,0,78,0,-78
11201,0,0,112,0,-112
11202,1,1,263,1305,1042
11203,1,0,56,0,-56
11204,0,0,45,0,-45
11205,1,1,288,2495,2207
11206,1,0,6,0,-6
11207,1,0,7,0,-7
11208,0,0,25,0,-25
11209,1,1,656,1464,808
11210,1,1,1077,1574,497
11211,0,0,33,0,-33
11212,0,0,17,0,-17
11213,0,0,230,0,-230
11214,1,0,17,0,-17
11215,0,0,90,0,-90
11216,0,0,4,0,-4
11217,0,0,107,0,-107
11218,1,1,286,1346,1060
11219,1,1,68,1539,1471
11220,1,0,25,0,-25
11221,1,0,15,0,-15
11222,0,0,45,0,-45
11223,1,1,617,1377,760
11224,0,0,2,0,-2
11225,1,0,77,0,-77
11226,0,0,23,0,-23
11227,1,1,428,1391,963
11228,1,1,952,1897,945
11229,1,0,24,0,-24
11230,1,0,82,0,-82
11231,1,1,590,1391,801
11232,1,0,57,0,-57
11233,0,0,16,0,-16
11234,1,1,1724,1432,-292
11235,0,0,105,0,-105
11236,0,0,1,0,-1
11237,0,0,46,0,-46
11238,1,1,761,1397,636
11239,0,0,69,0,-69
11240,0,0,6,0,-6
11241,1,0,46,0,-46
11242,1,1,187,1308,1121
11243,1,0,7,0,-7
11244,0,0,31,0,-31
11245,0,0,34,0,-34
11246,1,0,84,0,-84
11247,1,1,985,1765,780
11248,0,0,28,0,-28
11249,0,0,3,0,-3
11250,1,1,857,1246,389
11251,0,0,90,0,-90
11252,0,0,19,0,-19
11253,1,1,208,1690,1482
11254,1,1,697,2127,1430
11255,1,0,37,0,-37
11256,0,0,290,0,-290
11257,1,1,546,1211,665
11258,1,1,286,1454,1168
11259,0,0,63,0,-63
11260,0,0,15,0,-15
11261,1,0,82,0,-82
11262,1,1,427,1321,894
11263,1,1,593,1912,1319
11264,0,0,101,0,-101
11265,0,0,26,0,-26
11266,1,0,6,0,-6
11267,1,1,26,2518,2492
11268,1,1,68,1372,1304
11269,0,0,138,0,-138
11270,1,0,11,0,-11
11271,0,0,6,0,-6
11272,0,0,13,0,-13
11273,1,1,876,3465,2589
11274,1,1,1358,2744,1386
11275,0,0,4,0,-4
11276,0,0,41,0,-41
11277,0,0,1,0,-1
11278,0,0,38,0,-38
11279,1,1,746,1224,478
11280,1,1,543,1299,756
11281,1,0,91,0,-91
11282,1,1,1154,2060,906
11283,0,0,3,0,-3
11284,1,0,126,0,-126
11285,0,0,13,0,-13
11286,1,0,105,0,-105
11287,1,1,95,1271,1176
11288,1,0,32,0,-32
11289,1,0,21,0,-21
11290,0,0,63,0,-63
11291,0,0,37,0,-37
11292,0,0,8,0,-8
11293,0,0,32,0,-32
11294,1,1,352,1278,926
11295,1,1,235,1214,979
11296,1,0,60,0,-60
11297,1,1,883,1268,385
11298,1,1,712,1649,937
11299,0,0,70,0,-70
11300,1,0,106,0,-106
11301,1,0,71,0,-71
11302,0,0,65,0,-65
11303,1,0,29,0,-29
11304,1,0,54,0,-54
11305,0,0,74,0,-74
11306,1,0,87,0,-87
11307,0,0,17,0,-17
11308,0,0,18,0,-18
11309,1,1,996,1605,609
11310,1,0,28,0,-28
11311,1,1,323,1445,1122
11312,1,1,698,3391,2693
11313,1,0,39,0,-39
11314,1,1,155,1822,1667
11315,1,0,69,0,-69
11316,0,0,2,0,-2
11317,1,0,52,0,-52
11318,0,0,18,0,-18
11319,0,0,42,0,-42
11320,1,1,676,1364,688
11321,1,0,3,0,-3
11322,0,0,25,0,-25
11323,1,1,421,1211,790
11324,0,0,73,0,-73
11325,1,1,344,1770,1426
11326,0,0,33,0,-33
11327,1,0,100,0,-100
11328,1,0,6,0,-6
11329,1,1,476,1301,825
11330,1,0,76,0,-76
11331,1,1,1156,1470,314
11332,0,0,94,0,-94
11333,1,0,37,0,-37
11334,0,0,3,0,-3
11335,1,1,581,1411,830
11336,0,0,72,0,-72
11337,0,0,21,0,-21
11338,0,0,41,0,-41
11339,1,1,429,1393,964
11340,0,0,3,0,-3
11341,1,0,121,0,-121
11342,1,0,4,0,-4
11343,1,1,620,1241,621
11344,0,0,151,0,-151
11345,1,0,37,0,-37
11346,0,0,4,0,-4
11347,1,0,64,0,-64
11348,1,0,30,0,-30
11349,1,0,24,0,-24
11350,0,0,24,0,-24
11351,1,0,9,0,-9
11352,0,0,38,0,-38
11353,1,1,517,1656,1139
11354,1,1,52,1401,1349
11355,1,1,665,1661,996
11356,0,0,168,0,-168
11357,1,0,46,0,-46
11358,0,0,5,0,-5
11359,0,0,1,0,-1
11360,1,0,40,0,-40
11361,1,1,37,1320,1283
11362,1,1,166,1573,1407
11363,1,0,22,0,-22
11364,1,0,160,0,-160
11365,1,0,29,0,-29
11366,1,1,189,1280,1091
11367,1,0,2,0,-2
11368,1,0,33,0,-33
11369,1,1,343,1420,1077
11370,1,0,72,0,-72
11371,1,1,698,1250,552
11372,1,0,255,0,-255
11373,1,1,388,1808,1420
11374,1,1,87,1327,1240
11375,0,0,9,0,-9
11376,0,0,17,0,-17
11377,1,0,66,0,-66
11378,1,1,82,1696,1614
11379,1,0,6,0,-6
11380,0,0,6,0,-6
11381,1,0,149,0,-149
11382,0,0,34,0,-34
11383,0,0,13,0,-13
11384,1,0,31,0,-31
11385,0,0,63,0,-63
11386,1,0,8,0,-8
11387,1,1,1286,1679,393
11388,1,0,20,0,-20
11389,1,0,24,0,-24
11390,1,1,1352,1809,457
11391,1,0,280,0,-280
11392,1,0,159,0,-159
11393,0,0,90,0,-90
11394,1,0,24,0,-24
11395,0,0,11,0,-11
11396,0,0,8,0,-8
11397,0,0,22,0,-22
11398,0,0,32,0,-32
11399,0,0,4,0,-4
11400,0,0,112,0,-112
11401,0,0,17,0,-17
11402,1,0,97,0,-97
11403,1,1,1079,1204,125
11404,1,1,264,1594,1330
11405,1,1,33,1303,1270
11406,1,0,65,0,-65
11407,0,0,4,0,-4
11408,0,0,28,0,-28
11409,0,0,21,0,-21
11410,1,1,309,1273,964
11411,1,1,89,1621,1532
11412,1,1,564,2145,1581
11413,1,1,1471,1351,-120
11414,0,0,11,0,-11
11415,1,0,19,0,-19
11416,0,0,51,0,-51
11417,1,1,914,1576,662
11418,1,1,312,1410,1098
11419,1,0,30,0,-30
11420,1,1,117,1309,1192
11421,1,1,990,1712,722
11422,0,0,149,0,-149
11423,0,0,56,0,-56
11424,0,0,52,0,-52
11425,0,0,83,0,-83
11426,1,0,58,0,-58
11427,1,0,7,0,-7
11428,0,0,27,0,-27
11429,0,0,67,0,-67
11430,1,1,983,1228,245
11431,0,0,31,0,-31
11432,0,0,66,0,-66
11433,1,1,574,1976,1402
11434,0,0,139,0,-139
11435,1,0,30,0,-30
11436,0,0,32,0,-32
11437,1,1,31,1202,1171
11438,0,0,22,0,-22
11439,1,1,186,2057,1871
11440,1,1,247,1242,995
11441,1,0,13,0,-13
11442,1,0,32,0,-32
11443,0,0,87,0,-87
11444,1,1,308,1266,958
11445,1,0,30,0,-30
11446,0,0,3,0,-3
11447,0,0,205,0,-205
11448,0,0,49,0,-49
11449,0,0,118,0,-118
11450,0,0,35,0,-35
11451,1,1,142,1287,1145
11452,0,0,36,0,-36
11453,1,0,71,0,-71
11454,1,0,13,0,-13
11455,1,0,16,0,-16
11456,0,0,4,0,-4
11457,1,0,19,0,-19
11458,0,0,11,0,-11
11459,0,0,42,0,-42
11460,1,1,74,1492,1418
11461,0,0,92,0,-92
11462,0,0,13,0,-13
11463,1,1,28,1488,1460
11464,0,0,22,0,-22
11465,1,1,161,2207,2046
11466,1,0,0,0,0
11467,0,0,47,0,-47
11468,1,0,53,0,-53
11469,0,0,9,0,-9
11470,0,0,46,0,-46
11471,0,0,155,0,-155
11472,1,1,39,1559,1520
11473,1,0,105,0,-105
11474,1,1,858,1230,372
11475,1,0,23,0,-23
11476,1,0,83,0,-83
11477,1,0,113,0,-113
11478,0,0,149,0,-149
11479,0,0,135,0,-135
11480,0,0,19,0,-19
11481,0,0,103,0,-103
11482,1,1,302,1351,1049
11483,1,1,427,2379,1952
11484,0,0,101,0,-101
11485,0,0,16,0,-16
11486,1,0,54,0,-54
11487,0,0,42,0,-42
11488,1,0,20,0,-20
11489,1,1,1530,1271,-259
11490,1,0,49,0,-49
11491,0,0,19,0,-19
11492,0,0,33,0,-33
11493,0,0,44,0,-44
11494,0,0,21,0,-21
11495,0,0,3,0,-3
11496,1,0,77,0,-77
11497,0,0,1,0,-1
11498,0,0,0,0,0
11499,1,1,88,1340,1252
11500,1,0,94,0,-94
11501,0,0,62,0,-62
11502,1,0,40,0,-40
11503,1,0,66,0,-66
11504,0,0,138,0,-138
11505,1,0,75,0,-75
11506,1,0,62,0,-62
11507,0,0,1,0,-1
11508,0,0,48,0,-48
11509,0,0,20,0,-20
11510,0,0,57,0,-57
11511,0,0,21,0,-21
11512,1,0,5,0,-5
11513,1,0,130,0,-130
11514,1,1,1198,1505,307
11515,0,0,64,0,-64
11516,0,0,15,0,-15
11517,0,0,23,0,-23
11518,1,0,63,0,-63
11519,0,0,103,0,-103
11520,1,1,84,1618,1534
11521,0,0,78,0,-78
11522,0,0,24,0,-24
11523,1,0,135,0,-135
11524,1,1,460,1785,1325
11525,1,0,46,0,-46
11526,1,1,789,1849,1060
11527,1,0,10,0,-10
11528,0,0,35,0,-35
11529,0,0,17,0,-17
11530,1,0,102,0,-102
11531,0,0,55,0,-55
11532,0,0,26,0,-26
11533,0,0,50,0,-50
11534,0,0,148,0,-148
11535,0,0,6,0,-6
11536,1,0,31,0,-31
11537,1,0,17,0,-17
11538,1,0,8,0,-8
11539,1,1,147,1299,1152
11540,1,1,643,1270,627
11541,0,0,46,0,-46
11542,1,1,511,1382,871
11543,1,0,66,0,-66
11544,1,0,33,0,-33
11545,1,1,41,1534,1493
11546,1,1,172,1713,1541
11547,0,0,54,0,-54
11548,1,1,47,3029,2982
11549,1,0,17,0,-17
11550,0,0,21,0,-21
11551,1,0,59,0,-59
11552,0,0,24,0,-24
11553,0,0,4,0,-4
11554,1,1,439,1288,849
11555,1,0,255,0,-255
11556,1,0,5,0,-5
11557,0,0,121,0,-121
11558,0,0,44,0,-44
11559,0,0,11,0,-11
11560,1,0,55,0,-55
11561,0,0,3,0,-3
11562,1,1,568,2577,2009
11563,1,1,921,1535,614
11564,0,0,18,0,-18
11565,0,0,66,0,-66
11566,1,0,26,0,-26
11567,1,1,1947,1675,-272
11568,1,1,530,1288,758
11569,0,0,67,0,-67
11570,1,1,245,1810,1565
11571,0,0,35,0,-35
11572,1,0,42,0,-42
11573,0,0,9,0,-9
11574,1,1,622,3885,3263
11575,0,0,18,0,-18
11576,1,0,26,0,-26
11577,1,1,1327,1303,-24
11578,1,0,70,0,-70
11579,1,1,508,1338,830
11580,0,0,55,0,-55
11581,1,1,441,1871,1430
11582,1,0,61,0,-61
11583,1,1,4679,2164,-2515
11584,0,0,5,0,-5
11585,0,0,1,0,-1
11586,0,0,20,0,-20
11587,1,1,900,1200,300
11588,0,0,13,0,-13
11589,1,0,31,0,-31
11590,1,0,125,0,-125
11591,1,1,189,1771,1582
11592,1,0,3,0,-3
11593,1,0,38,0,-38
11594,1,0,40,0,-40
11595,1,0,36,0,-36
11596,1,1,370,1222,852
11597,0,0,13,0,-13
11598,0,0,76,0,-76
11599,1,0,49,0,-49
11600,1,0,73,0,-73
11601,0,0,16,0,-16
11602,1,0,18,0,-18
11603,0,0,25,0,-25
11604,0,0,18,0,-18
11605,1,1,557,1663,1106
11606,0,0,62,0,-62
11607,1,0,2,0,-2
11608,1,0,98,0,-98
11609,0,0,9,0,-9
11610,1,0,4,0,-4
11611,1,1,478,1629,1151
11612,1,1,368,1364,996
11613,1,0,46,0,-46
11614,1,0,36,0,-36
11615,0,0,78,0,-78
11616,1,1,107,1330,1223
11617,1,0,6,0,-6
11618,1,0,19,0,-19
11619,0,0,122,0,-122
11620,1,1,817,1658,841
11621,1,0,19,0,-19
11622,1,1,714,1610,896
11623,0,0,3,0,-3
11624,1,1,590,1429,839
11625,0,0,8,0,-8
11626,1,0,60,0,-60
11627,0,0,210,0,-210
11628,0,0,119,0,-119
11629,1,1,679,1241,562
11630,1,1,131,1833,1702
11631,0,0,152,0,-152
11632,1,0,103,0,-103
11633,0,0,12,0,-12
11634,0,0,5,0,-5
11635,0,0,13,0,-13
11636,1,0,117,0,-117
11637,0,0,43,0,-43
11638,1,0,10,0,-10
11639,1,1,79,1314,1235
11640,1,0,12,0,-12
11641,1,0,80,0,-80
11642,0,0,151,0,-151
11643,1,1,817,2969,2152
11644,1,0,8,0,-8
11645,0,0,4,0,-4
11646,0,0,139,0,-139
11647,1,0,2,0,-2
11648,1,1,837,1329,492
11649,0,0,37,0,-37
11650,1,0,0,0,0
11651,0,0,36,0,-36
11652,1,1,1336,1209,-127
11653,0,0,150,0,-150
11654,0,0,34,0,-34
11655,1,1,302,1511,1209
11656,1,1,962,1831,869
11657,1,0,94,0,-94
11658,1,0,97,0,-97
11659,1,0,84,0,-84
11660,1,1,843,1814,971
11661,1,0,80,0,-80
11662,1,1,401,1525,1124
11663,1,1,2052,1230,-822
11664,0,0,8,0,-8
11665,1,0,90,0,-90
11666,0,0,69,0,-69
11667,0,0,10,0,-10
11668,1,1,654,1392,738
11669,1,1,436,1264,828
11670,1,0,24,0,-24
11671,1,0,15,0,-15
11672,1,0,6,0,-6
11673,1,1,125,1325,1200
11674,0,0,57,0,-57
11675,0,0,58,0,-58
11676,1,1,177,1815,1638
11677,1,0,15,0,-15
11678,1,1,117,2155,2038
11679,1,0,87,0,-87
11680,0,0,26,0,-26
11681,1,0,188,0,-188
11682,1,0,43,0,-43
11683,0,0,83,0,-83
11684,1,1,1407,1297,-110
11685,1,0,45,0,-45
11686,0,0,40,0,-40
11687,1,1,943,1292,349
11688,0,0,104,0,-104
11689,0,0,58,0,-58
11690,1,1,596,1623,1027
11691,1,0,196,0,-196
11692,0,0,92,0,-92
11693,1,0,86,0,-86
11694,0,0,28,0,-28
11695,1,1,779,1792,1013
11696,1,1,55,1263,1208
11697,1,1,1183,2143,960
11698,0,0,79,0,-79
11699,0,0,7,0,-7
11700,0,0,31,0,-31
11701,1,1,266,1204,938
11702,1,0,40,0,-40
11703,1,1,100,2157,2057
11704,1,0,60,0,-60
11705,0,0,76,0,-76
11706,1,1,1146,1232,86
11707,0,0,117,0,-117
11708,0,0,25,0,-25
11709,0,0,100,0,-100
11710,0,0,48,0,-48
11711,1,0,8,0,-8
11712,1,0,119,0,-119
11713,1,0,30,0,-30
11714,0,0,42,0,-42
11715,1,1,114,1240,1126
11716,1,0,92,0,-92
11717,1,0,61,0,-61
11718,0,0,23,0,-23
11719,1,1,472,1783,1311
11720,1,0,52,0,-52
11721,0,0,30,0,-30
11722,0,0,185,0,-185
11723,0,0,77,0,-77
11724,1,0,36,0,-36
11725,0,0,103,0,-103
11726,0,0,59,0,-59
11727,1,1,124,1203,1079
11728,1,0,12,0,-12
11729,0,0,18,0,-18
11730,0,0,29,0,-29
11731,1,0,118,0,-118
11732,0,0,23,0,-23
11733,1,0,29,0,-29
11734,1,1,612,1492,880
11735,0,0,19,0,-19
11736,1,0,210,0,-210
11737,1,1,531,2728,2197
11738,0,0,10,0,-10
11739,1,1,759,1443,684
11740,0,0,70,0,-70
11741,1,0,11,0,-11
11742,0,0,20,0,-20
11743,1,0,82,0,-82
11744,0,0,1,0,-1
11745,1,0,2,0,-2
11746,0,0,8,0,-8
11747,1,1,841,1208,367
11748,1,1,330,1510,1180
11749,1,1,166,2397,2231
11750,1,0,4,0,-4
11751,1,1,169,1389,1220
11752,1,1,1401,1359,-42
11753,0,0,44,0,-44
11754,0,0,25,0,-25
11755,0,0,4,0,-4
11756,1,0,0,0,0
11757,1,1,167,1562,1395
11758,1,0,54,0,-54
11759,1,1,841,1550,709
11760,1,1,346,1524,1178
11761,0,0,71,0,-71
11762,1,1,1091,1251,160
11763,1,0,7,0,-7
11764,1,0,14,0,-14
11765,1,0,7,0,-7
11766,0,0,11,0,-11
11767,1,0,176,0,-176
11768,1,0,7,0,-7
11769,1,1,121,1449,1328
11770,1,0,78,0,-78
11771,0,0,48,0,-48
11772,0,0,116,0,-116
11773,0,0,92,0,-92
11774,0,0,59,0,-59
11775,1,1,97,1256,1159
11776,1,1,145,1319,1174
11777,0,0,0,0,0
11778,1,1,598,1315,717
11779,0,0,3,0,-3
11780,1,1,782,1304,522
11781,1,0,103,0,-103
11782,0,0,90,0,-90
11783,1,1,316,1263,947
11784,1,0,92,0,-92
11785,1,0,9,0,-9
11786,1,0,106,0,-106
11787,0,0,4,0,-4
11788,1,1,234,2395,2161
11789,0,0,22,0,-22
11790,0,0,60,0,-60
11791,1,0,46,0,-46
11792,0,0,97,0,-97
11793,0,0,39,0,-39
11794,1,0,35,0,-35
11795,1,0,30,0,-30
11796,1,1,2545,1205,-1340
11797,1,1,93,2034,1941
11798,0,0,22,0,-22
11799,1,1,135,1312,1177
11800,1,1,957,1209,252
11801,1,0,25,0,-25
11802,1,1,700,1418,718
11803,1,0,53,0,-53
11804,0,0,182,0,-182
11805,0,0,44,0,-44
11806,1,1,95,2201,2106
11807,1,0,32,0,-32
11808,1,1,2708,1237,-1471
11809,0,0,103,0,-103
11810,0,0,20,0,-20
11811,0,0,31,0,-31
11812,1,1,139,1522,1383
11813,1,0,6,0,-6
11814,1,0,117,0,-117
11815,1,0,51,0,-51
11816,0,0,169,0,-169
11817,1,1,880,1452,572
11818,1,0,2,0,-2
11819,0,0,10,0,-10
11820,1,1,206,1374,1168
11821,1,0,119,0,-119
11822,0,0,22,0,-22
11823,1,0,49,0,-49
11824,1,0,48,0,-48
11825,0,0,7,0,-7
11826,0,0,2,0,-2
11827,1,0,18,0,-18
11828,1,1,74,1273,1199
11829,0,0,19,0,-19
11830,0,0,90,0,-90
11831,1,0,9,0,-9
11832,0,0,89,0,-89
11833,1,1,1020,1383,363
11834,0,0,107,0,-107
11835,0,0,3,0,-3
11836,0,0,11,0,-11
11837,1,0,115,0,-115
11838,1,0,19,0,-19
11839,1,1,99,1582,1483
11840,1,1,405,1371,966
11841,0,0,96,0,-96
11842,0,0,213,0,-213
11843,1,0,15,0,-15
11844,0,0,51,0,-51
11845,1,0,5,0,-5
11846,1,0,81,0,-81
11847,1,1,351,1625,1274
11848,1,1,316,1323,1007
11849,1,0,54,0,-54
11850,1,0,12,0,-12
11851,1,0,0,0,0
11852,0,0,45,0,-45
11853,1,1,145,1921,1776
11854,1,0,12,0,-12
11855,0,0,28,0,-28
11856,1,0,161,0,-161
11857,1,0,87,0,-87
11858,1,1,625,1310,685
11859,1,1,261,1388,1127
11860,0,0,38,0,-38
11861,0,0,0,0,0
11862,0,0,197,0,-197
11863,0,0,46,0,-46
11864,1,1,363,1230,867
11865,0,0,22,0,-22
11866,1,1,181,1276,1095
11867,1,1,2290,1270,-1020
11868,1,1,1374,1440,66
11869,0,0,151,0,-151
11870,1,1,710,1240,530
11871,1,1,1181,1440,259
11872,0,0,26,0,-26
11873,1,1,565,1410,845
11874,1,1,685,1468,783
11875,0,0,15,0,-15
11876,1,0,33,0,-33
11877,1,1,339,1628,1289
11878,1,1,301,1518,1217
11879,1,1,158,1309,1151
11880,1,0,2,0,-2
11881,1,0,35,0,-35
11882,1,0,10,0,-10
11883,1,1,205,1849,1644
11884,1,0,54,0,-54
11885,0,0,14,0,-14
11886,1,0,29,0,-29
11887,1,1,761,1218,457
11888,1,0,1,0,-1
11889,1,1,173,2324,2151
11890,0,0,84,0,-84
11891,1,1,316,1368,1052
11892,0,0,22,0,-22
11893,0,0,13,0,-13
11894,1,0,27,0,-27
11895,0,0,69,0,-69
11896,0,0,63,0,-63
11897,1,0,16,0,-16
11898,1,0,2,0,-2
11899,1,0,26,0,-26
11900,0,0,6,0,-6
11901,1,1,965,1403,438
11902,1,0,22,0,-22
11903,0,0,202,0,-202
11904,1,0,2,0,-2
11905,0,0,168,0,-168
11906,0,0,36,0,-36
11907,1,1,233,1383,1150
11908,0,0,128,0,-128
11909,0,0,60,0,-60
11910,1,1,84,1384,1300
11911,1,1,875,1347,472
11912,1,0,3,0,-3
11913,1,1,82,1656,1574
11914,0,0,73,0,-73
11915,0,0,4,0,-4
11916,0,0,84,0,-84
11917,1,1,525,1305,780
11918,1,1,184,1764,1580
11919,0,0,41,0,-41
11920,1,1,840,1461,621
11921,0,0,42,0,-42
11922,0,0,98,0,-98
11923,1,1,679,1274,595
11924,0,0,41,0,-41
11925,1,1,161,1437,1276
11926,0,0,50,0,-50
11927,0,0,13,0,-13
11928,1,1,554,1391,837
11929,0,0,11,0,-11
11930,0,0,4,0,-4
11931,1,1,938,1776,838
11932,1,1,52,1209,1157
11933,1,0,40,0,-40
11934,1,0,102,0,-102
11935,1,0,0,0,0
11936,0,0,24,0,-24
11937,1,0,6,0,-6
11938,1,0,45,0,-45
11939,0,0,24,0,-24
11940,0,0,41,0,-41
11941,1,1,511,1445,934
11942,0,0,67,0,-67
11943,1,1,510,1427,917
11944,1,1,80,1296,1216
11945,1,1,123,1489,1366
11946,1,0,6,0,-6
11947,0,0,12,0,-12
11948,1,1,73,1261,1188
11949,1,1,49,1620,1571
11950,0,0,3,0,-3
11951,1,0,24,0,-24
11952,1,1,93,1279,1186
11953,1,0,2,0,-2
11954,1,0,130,0,-130
11955,0,0,34,0,-34
11956,1,0,44,0,-44
11957,1,1,104,2272,2168
11958,1,0,86,0,-86
11959,1,0,43,0,-43
11960,0,0,14,0,-14
11961,1,0,5,0,-5
11962,1,1,329,1346,1017
11963,1,1,1033,1479,446
11964,1,1,109,1244,1135
11965,0,0,35,0,-35
11966,1,1,747,1340,593
11967,1,0,18,0,-18
11968,0,0,42,0,-42
11969,1,0,17,0,-17
11970,1,0,1,0,-1
11971,1,1,28,1418,1390
11972,0,0,47,0,-47
11973,1,1,180,1380,1200
11974,1,0,239,0,-239
11975,0,0,10,0,-10
11976,1,0,119,0,-119
11977,1,0,9,0,-9
11978,1,0,91,0,-91
11979,1,1,190,1306,1116
11980,0,0,50,0,-50
11981,0,0,53,0,-53
11982,1,0,1,0,-1
11983,0,0,94,0,-94
11984,1,0,59,0,-59
11985,1,0,3,0,-3
11986,0,0,105,0,-105
11987,1,0,74,0,-74
11988,0,0,115,0,-115
11989,0,0,20,0,-20
11990,0,0,39,0,-39
11991,0,0,54,0,-54
11992,1,0,51,0,-51
11993,1,0,3,0,-3
11994,1,0,59,0,-59
11995,1,0,20,0,-20
11996,1,1,539,1623,1084
11997,1,1,253,1339,1086
11998,1,1,771,1255,484
11999,1,1,155,1545,1390
12000,1,1,888,1207,319
12001,1,1,1093,2589,1496
12002,1,0,34,0,-34
12003,0,0,39,0,-39
12004,1,1,221,1407,1186
12005,1,0,147,0,-147
12006,1,0,6,0,-6
12007,0,0,85,0,-85
12008,0,0,20,0,-20
12009,1,1,59,1510,1451
12010,1,1,257,2156,1899
12011,0,0,23,0,-23
12012,0,0,97,0,-97
12013,1,1,204,1345,1141
12014,1,0,10,0,-10
12015,0,0,42,0,-42
12016,0,0,100,0,-100
12017,0,0,13,0,-13
12018,0,0,83,0,-83
12019,1,1,320,1857,1537
12020,1,1,1310,2803,1493
12021,0,0,11,0,-11
12022,1,1,152,1565,1413
12023,1,1,1101,1693,592
12024,1,1,1369,1617,248
12025,1,1,64,1409,1345
12026,1,0,18,0,-18
12027,0,0,5,0,-5
12028,1,0,70,0,-70
12029,0,0,186,0,-186
12030,0,0,112,0,-112
12031,0,0,8,0,-8
12032,1,1,1422,4448,3026
12033,0,0,49,0,-49
12034,1,0,59,0,-59
12035,1,1,1546,1357,-189
12036,1,0,57,0,-57
12037,1,1,91,1478,1387
12038,1,0,38,0,-38
12039,0,0,41,0,-41
12040,1,0,131,0,-131
12041,0,0,24,0,-24
12042,1,1,260,1521,1261
12043,1,0,186,0,-186
12044,0,0,51,0,-51
12045,1,1,923,2010,1087
12046,1,1,128,1200,1072
12047,0,0,14,0,-14
12048,1,1,1480,1287,-193
12049,0,0,1,0,-1
12050,1,0,63,0,-63
12051,1,1,429,1623,1194
12052,1,0,21,0,-21
12053,0,0,67,0,-67
12054,0,0,86,0,-86
12055,0,0,141,0,-141
12056,1,1,553,2109,1556
12057,0,0,6,0,-6
12058,1,1,254,1771,1517
12059,1,0,26,0,-26
12060,1,0,93,0,-93
12061,1,0,46,0,-46
12062,0,0,17,0,-17
12063,0,0,1,0,-1
12064,1,0,113,0,-113
12065,1,1,288,1360,1072
12066,1,0,6,0,-6
12067,0,0,21,0,-21
12068,0,0,1,0,-1
12069,1,0,2,0,-2
12070,1,1,596,1207,611
12071,0,0,5,0,-5
12072,0,0,50,0,-50
12073,0,0,93,0,-93
12074,1,1,218,1567,1349
12075,1,1,340,1800,1460
12076,0,0,2,0,-2
12077,1,0,54,0,-54
12078,1,1,563,1928,1365
12079,1,1,733,1791,1058
12080,1,1,378,1530,1152
12081,1,0,35,0,-35
12082,1,0,19,0,-19
12083,1,1,881,1256,375
12084,0,0,179,0,-179
12085,1,1,201,1460,1259
12086,1,0,93,0,-93
12087,0,0,81,0,-81
12088,1,1,612,1800,1188
12089,1,0,103,0,-103
12090,0,0,48,0,-48
12091,1,1,491,1399,908
12092,0,0,0,0,0
12093,1,1,59,1864,1805
12094,1,0,103,0,-103
12095,1,1,237,1383,1146
12096,1,1,1474,1242,-232
12097,1,1,272,2204,1932
12098,1,0,7,0,-7
12099,1,0,67,0,-67
12100,1,1,670,1201,531
12101,1,0,44,0,-44
12102,0,0,0,0,0
12103,1,1,422,1562,1140
12104,0,0,5,0,-5
12105,1,1,671,1490,819
12106,1,1,625,1340,715
12107,0,0,137,0,-137
12108,1,0,46,0,-46
12109,0,0,0,0,0
12110,1,0,15,0,-15
12111,1,1,873,1270,397
12112,1,0,49,0,-49
12113,1,1,592,1247,655
12114,1,0,131,0,-131
12115,1,1,263,1222,959
12116,1,1,2535,1376,-1159
12117,1,0,7,0,-7
12118,1,0,51,0,-51
12119,0,0,80,0,-80
12120,1,1,279,1582,1303
12121,1,0,171,0,-171
12122,0,0,21,0,-21
12123,1,0,86,0,-86
12124,0,0,30,0,-30
12125,0,0,64,0,-64
12126,1,0,135,0,-135
12127,0,0,1,0,-1
12128,0,0,16,0,-16
12129,0,0,30,0,-30
12130,0,0,41,0,-41
12131,0,0,9,0,-9
12132,1,1,689,1312,623
12133,1,1,1100,1435,335
12134,0,0,28,0,-28
12135,1,1,451,1272,821
12136,1,1,519,1251,732
12137,1,0,24,0,-24
12138,1,0,27,0,-27
12139,1,0,34,0,-34
12140,1,0,0,0,0
12141,0,0,35,0,-35
12142,1,0,127,0,-127
12143,1,0,9,0,-9
12144,1,1,162,1236,1074
12145,1,0,11,0,-11
12146,0,0,5,0,-5
12147,1,1,725,1479,754
12148,0,0,39,0,-39
12149,0,0,2,0,-2
12150,0,0,53,0,-53
12151,1,1,189,1493,1304
12152,0,0,72,0,-72
12153,1,0,2,0,-2
12154,1,1,443,1517,1074
12155,1,0,53,0,-53
12156,0,0,53,0,-53
12157,1,0,39,0,-39
12158,1,1,760,1399,639
12159,1,0,29,0,-29
12160,0,0,42,0,-42
12161,0,0,14,0,-14
12162,1,0,8,0,-8
12163,0,0,140,0,-140
12164,0,0,12,0,-12
12165,1,1,431,1275,844
12166,0,0,27,0,-27
12167,0,0,10,0,-10
12168,1,0,106,0,-106
12169,1,1,1395,1453,58
12170,0,0,0,0,0
12171,1,0,1,0,-1
12172,0,0,24,0,-24
12173,1,0,3,0,-3
12174,0,0,75,0,-75
12175,1,1,42,1335,1293
12176,1,1,1046,1813,767
12177,0,0,14,0,-14
12178,1,1,436,1262,826
12179,0,0,36,0,-36
12180,0,0,42,0,-42
12181,1,0,40,0,-40
12182,1,0,79,0,-79
12183,0,0,6,0,-6
12184,1,1,447,2003,1556
12185,0,0,72,0,-72
12186,0,0,46,0,-46
12187,1,0,68,0,-68
12188,0,0,79,0,-79
12189,1,0,43,0,-43
12190,1,0,12,0,-12
12191,1,1,254,1839,1585
12192,1,0,44,0,-44
12193,1,0,25,0,-25
12194,1,0,8,0,-8
12195,0,0,59,0,-59
12196,1,0,118,0,-118
12197,1,1,390,1447,1057
12198,1,1,302,1351,1049
12199,1,0,108,0,-108
12200,0,0,26,0,-26
12201,1,1,1060,1328,268
12202,1,0,52,0,-52
12203,0,0,14,0,-14
12204,0,0,3,0,-3
12205,1,0,13,0,-13
12206,1,0,13,0,-13
12207,1,1,565,1278,713
12208,0,0,94,0,-94
12209,0,0,49,0,-49
12210,1,1,320,1303,983
12211,1,0,96,0,-96
12212,1,1,148,1930,1782
12213,1,0,32,0,-32
12214,1,0,195,0,-195
12215,1,1,1483,1346,-137
12216,1,0,64,0,-64
12217,0,0,25,0,-25
12218,1,1,380,1257,877
12219,1,0,98,0,-98
12220,0,0,1,0,-1
12221,1,1,1020,2574,1554
12222,0,0,39,0,-39
12223,0,0,17,0,-17
12224,1,0,56,0,-56
12225,0,0,46,0,-46
12226,0,0,0,0,0
12227,1,0,1,0,-1
12228,1,0,41,0,-41
12229,0,0,66,0,-66
12230,1,1,1678,1480,-198
12231,1,1,143,1382,1239
12232,1,1,192,1699,1507
12233,1,0,19,0,-19
12234,1,0,73,0,-73
12235,1,1,284,1277,993
12236,0,0,135,0,-135
12237,1,1,408,2338,1930
12238,1,1,799,1322,523
12239,0,0,6,0,-6
12240,1,0,92,0,-92
12241,0,0,191,0,-191
12242,0,0,39,0,-39
12243,0,0,7,0,-7
12244,0,0,50,0,-50
12245,0,0,62,0,-62
12246,1,0,19,0,-19
12247,1,0,2,0,-2
12248,1,0,12,0,-12
12249,0,0,75,0,-75
12250,1,0,34,0,-34
12251,0,0,65,0,-65
12252,1,0,18,0,-18
12253,1,1,494,1298,804
12254,1,0,35,0,-35
12255,0,0,33,0,-33
12256,0,0,99,0,-99
12257,1,1,662,1885,1223
12258,0,0,38,0,-38
12259,0,0,8,0,-8
12260,0,0,16,0,-16
12261,1,1,685,1442,757
12262,1,1,1730,1200,-530
12263,1,0,2,0,-2
12264,1,0,111,0,-111
12265,0,0,44,0,-44
12266,0,0,31,0,-31
12267,0,0,12,0,-12
12268,0,0,12,0,-12
12269,1,1,162,1542,1380
12270,1,0,3,0,-3
12271,1,1,898,1244,346
12272,1,0,64,0,-64
12273,0,0,49,0,-49
12274,1,0,95,0,-95
12275,0,0,5,0,-5
12276,1,1,2270,2214,-56
12277,1,0,15,0,-15
12278,1,1,973,1244,271
12279,1,1,552,1397,845
12280,1,0,26,0,-26
12281,1,1,1229,1801,572
12282,1,1,989,1315,326
12283,0,0,71,0,-71
12284,1,0,6,0,-6
12285,0,0,46,0,-46
12286,1,1,1204,1207,3
12287,1,1,355,1479,1124
12288,1,0,2,0,-2
12289,0,0,8,0,-8
12290,1,0,13,0,-13
12291,0,0,152,0,-152
12292,0,0,19,0,-19
12293,1,1,762,2466,1704
12294,0,0,114,0,-114
12295,0,0,14,0,-14
12296,1,0,9,0,-9
12297,1,1,50,1266,1216
12298,1,1,196,1321,1125
12299,1,1,157,1598,1441
12300,1,1,136,1605,1469
12301,0,0,1,0,-1
12302,1,1,503,1700,1197
12303,0,0,71,0,-71
12304,1,0,39,0,-39
12305,1,0,9,0,-9
12306,0,0,77,0,-77
12307,0,0,16,0,-16
12308,0,0,68,0,-68
12309,0,0,48,0,-48
12310,1,1,248,1234,986
12311,0,0,65,0,-65
12312,1,0,48,0,-48
12313,0,0,1,0,-1
12314,1,1,365,1927,1562
12315,1,1,652,1247,595
12316,0,0,25,0,-25
12317,0,0,27,0,-27
12318,0,0,8,0,-8
12319,1,0,4,0,-4
12320,1,1,1154,1799,645
12321,1,0,45,0,-45
12322,1,1,1099,1273,174
12323,1,1,106,1444,1338
12324,1,0,28,0,-28
12325,1,1,27,1322,1295
12326,1,1,629,1835,1206
12327,1,0,36,0,-36
12328,1,1,162,1847,1685
12329,0,0,210,0,-210
12330,1,1,1168,3141,1973
12331,1,1,665,1462,797
12332,0,0,4,0,-4
12333,0,0,36,0,-36
12334,1,1,274,1503,1229
12335,0,0,1,0,-1
12336,1,0,20,0,-20
12337,1,1,322,1300,978
12338,1,1,119,1329,1210
12339,1,1,280,1360,1080
12340,0,0,6,0,-6
12341,1,1,227,1358,1131
12342,1,1,339,1322,983
12343,1,0,2,0,-2
12344,1,0,60,0,-60
12345,0,0,197,0,-197
12346,0,0,9,0,-9
12347,0,0,5,0,-5
12348,1,0,33,0,-33
12349,1,0,35,0,-35
12350,0,0,122,0,-122
12351,1,0,29,0,-29
12352,0,0,72,0,-72
12353,1,0,59,0,-59
12354,0,0,20,0,-20
12355,1,0,96,0,-96
12356,0,0,24,0,-24
12357,0,0,27,0,-27
12358,1,0,14,0,-14
12359,1,1,1267,1218,-49
12360,0,0,37,0,-37
12361,0,0,6,0,-6
12362,1,0,3,0,-3
12363,1,1,728,2271,1543
12364,0,0,41,0,-41
12365,1,0,80,0,-80
12366,1,0,23,0,-23
12367,1,1,658,1314,656
12368,0,0,21,0,-21
12369,0,0,41,0,-41
12370,0,0,15,0,-15
12371,0,0,108,0,-108
12372,0,0,79,0,-79
12373,0,0,13,0,-13
12374,1,1,112,1715,1603
12375,1,1,745,1225,480
12376,0,0,6,0,-6
12377,1,0,44,0,-44
12378,1,1,780,1407,627
12379,1,0,60,0,-60
12380,0,0,45,0,-45
12381,1,0,1,0,-1
12382,1,1,288,1667,1379
12383,1,1,1266,2748,1482
12384,1,1,430,1260,830
12385,1,1,100,1570,1470
12386,1,0,12,0,-12
12387,0,0,66,0,-66
12388,0,0,40,0,-40
12389,0,0,26,0,-26
12390,0,0,34,0,-34
12391,0,0,7,0,-7
12392,1,1,750,1625,875
12393,1,0,102,0,-102
12394,1,0,42,0,-42
12395,1,1,83,1599,1516
12396,0,0,158,0,-158
12397,1,1,132,4336,4204
12398,0,0,66,0,-66
12399,1,0,13,0,-13
12400,1,0,9,0,-9
12401,1,1,390,1442,1052
12402,1,0,0,0,0
12403,1,0,40,0,-40
12404,1,1,514,1896,1382
12405,1,1,726,1662,936
12406,1,1,544,1492,948
12407,1,0,47,0,-47
12408,0,0,25,0,-25
12409,1,1,910,1232,322
12410,1,0,145,0,-145
12411,0,0,66,0,-66
12412,0,0,63,0,-63
12413,0,0,27,0,-27
12414,1,0,126,0,-126
12415,0,0,13,0,-13
12416,0,0,6,0,-6
12417,1,1,55,1630,1575
12418,0,0,28,0,-28
12419,0,0,4,0,-4
12420,0,0,92,0,-92
12421,1,1,55,1336,1281
12422,1,1,465,1249,784
12423,1,1,811,2175,1364
12424,1,0,35,0,-35
12425,0,0,18,0,-18
12426,1,0,2,0,-2
12427,1,1,123,1490,1367
12428,1,1,935,2440,1505
12429,1,0,107,0,-107
12430,0,0,25,0,-25
12431,0,0,14,0,-14
12432,0,0,3,0,-3
12433,1,0,11,0,-11
12434,0,0,23,0,-23
12435,0,0,49,0,-49
12436,0,0,52,0,-52
12437,1,1,100,1417,1317
12438,1,0,80,0,-80
12439,0,0,99,0,-99
12440,1,0,39,0,-39
12441,1,0,101,0,-101
12442,0,0,39,0,-39
12443,1,0,65,0,-65
12444,0,0,7,0,-7
12445,1,1,88,1200,1112
12446,1,1,165,1940,1775
12447,1,1,190,1882,1692
12448,1,0,23,0,-23
12449,1,0,29,0,-29
12450,1,0,9,0,-9
12451,0,0,36,0,-36
12452,1,0,12,0,-12
12453,1,0,133,0,-133
12454,0,0,1,0,-1
12455,1,1,110,1628,1518
12456,1,0,41,0,-41
12457,1,0,60,0,-60
12458,1,0,92,0,-92
12459,1,1,1932,1463,-469
12460,1,0,36,0,-36
12461,1,1,1230,1210,-20
12462,1,0,2,0,-2
12463,0,0,142,0,-142
12464,0,0,42,0,-42
12465,0,0,20,0,-20
12466,1,1,108,1519,1411
12467,1,0,29,0,-29
12468,1,0,71,0,-71
12469,1,0,14,0,-14
12470,1,1,535,1877,1342
12471,1,0,121,0,-121
12472,0,0,1,0,-1
12473,1,0,46,0,-46
12474,1,0,81,0,-81
12475,0,0,15,0,-15
12476,0,0,43,0,-43
12477,1,1,1548,1276,-272
12478,1,0,162,0,-162
12479,0,0,50,0,-50
12480,1,0,72,0,-72
12481,1,0,43,0,-43
12482,1,1,268,1222,954
12483,0,0,36,0,-36
12484,1,1,311,1275,964
12485,0,0,80,0,-80
12486,1,1,5,1399,1394
12487,1,1,304,1328,1024
12488,0,0,54,0,-54
12489,0,0,41,0,-41
12490,1,1,265,1364,1099
12491,1,0,41,0,-41
12492,0,0,48,0,-48
12493,0,0,111,0,-111
12494,0,0,8,0,-8
12495,1,0,171,0,-171
12496,0,0,148,0,-148
12497,1,0,12,0,-12
12498,1,0,8,0,-8
12499,1,0,79,0,-79
12500,0,0,60,0,-60
12501,1,1,868,4417,3549
12502,1,1,407,1581,1174
12503,0,0,37,0,-37
12504,1,0,66,0,-66
12505,0,0,31,0,-31
12506,1,1,711,1940,1229
12507,0,0,57,0,-57
12508,1,0,13,0,-13
12509,1,0,103,0,-103
12510,0,0,3,0,-3
12511,1,1,1692,1246,-446
12512,1,0,22,0,-22
12513,0,0,91,0,-91
12514,0,0,18,0,-18
12515,1,0,69,0,-69
12516,1,1,1157,1670,513
12517,1,0,1,0,-1
12518,0,0,22,0,-22
12519,1,0,143,0,-143
12520,0,0,124,0,-124
12521,0,0,90,0,-90
12522,0,0,77,0,-77
12523,0,0,67,0,-67
12524,0,0,37,0,-37
12525,1,0,77,0,-77
12526,1,0,35,0,-35
12527,1,1,294,1925,1631
12528,1,0,172,0,-172
12529,0,0,23,0,-23
12530,1,0,15,0,-15
12531,0,0,76,0,-76
12532,0,0,19,0,-19
12533,1,0,21,0,-21
12534,0,0,81,0,-81
12535,1,1,840,1242,402
12536,1,1,237,1505,1268
12537,0,0,0,0,0
12538,0,0,13,0,-13
12539,0,0,14,0,-14
12540,1,1,413,1890,1477
12541,1,0,160,0,-160
12542,0,0,8,0,-8
12543,0,0,8,0,-8
12544,0,0,0,0,0
12545,0,0,34,0,-34
12546,1,0,28,0,-28
12547,1,0,36,0,-36
12548,0,0,34,0,-34
12549,0,0,129,0,-129
12550,0,0,17,0,-17
12551,1,1,658,1600,942
12552,1,0,94,0,-94
12553,1,1,269,1556,1287
12554,1,1,325,1233,908
12555,1,0,66,0,-66
12556,0,0,3,0,-3
12557,0,0,63,0,-63
12558,1,1,963,1717,754
12559,1,1,564,1203,639
12560,1,1,574,1269,695
12561,1,1,289,1590,1301
12562,1,0,57,0,-57
12563,1,1,262,1285,1023
12564,1,1,771,1454,683
12565,1,1,275,1285,1010
12566,1,1,780,1238,458
12567,1,0,0,0,0
12568,1,0,27,0,-27
12569,1,1,631,2110,1479
12570,1,0,90,0,-90
12571,0,0,18,0,-18
12572,0,0,8,0,-8
12573,1,0,46,0,-46
12574,1,0,8,0,-8
12575,0,0,75,0,-75
12576,0,0,42,0,-42
12577,1,1,593,1223,630
12578,1,1,318,1206,888
12579,0,0,41,0,-41
12580,1,0,1,0,-1
12581,1,1,265,1490,1225
12582,1,1,195,1630,1435
12583,1,0,58,0,-58
12584,1,0,52,0,-52
12585,1,1,292,1237,945
12586,1,1,420,1594,1174
12587,1,0,4,0,-4
12588,0,0,26,0,-26
12589,0,0,33,0,-33
12590,1,1,177,1236,1059
12591,1,1,386,2763,2377
12592,0,0,183,0,-183
12593,1,0,20,0,-20
12594,1,0,11,0,-11
12595,1,0,18,0,-18
12596,1,1,298,2010,1712
12597,1,0,122,0,-122
12598,0,0,17,0,-17
12599,0,0,115,0,-115
12600,1,0,5,0,-5
12601,1,1,279,1294,1015
12602,0,0,57,0,-57
12603,0,0,71,0,-71
12604,1,0,18,0,-18
12605,1,0,75,0,-75
12606,1,0,130,0,-130
12607,1,0,23,0,-23
12608,0,0,89,0,-89
12609,1,1,699,1314,615
12610,0,0,5,0,-5
12611,1,0,53,0,-53
12612,1,1,168,1246,1078
12613,1,0,71,0,-71
12614,1,0,8,0,-8
12615,0,0,17,0,-17
12616,1,0,41,0,-41
12617,0,0,53,0,-53
12618,1,0,16,0,-16
12619,1,0,65,0,-65
12620,0,0,49,0,-49
12621,1,0,60,0,-60
12622,1,0,170,0,-170
12623,1,1,593,1432,839
12624,1,0,50,0,-50
12625,0,0,83,0,-83
12626,1,1,323,1770,1447
12627,0,0,84,0,-84
12628,1,0,67,0,-67
12629,1,0,8,0,-8
12630,1,0,118,0,-118
12631,0,0,63,0,-63
12632,0,0,13,0,-13
12633,1,0,47,0,-47
12634,1,1,1336,1498,162
12635,1,0,98,0,-98
12636,1,0,30,0,-30
12637,0,0,60,0,-60
12638,1,0,67,0,-67
12639,0,0,3,0,-3
12640,0,0,60,0,-60
12641,1,0,2,0,-2
12642,0,0,162,0,-162
12643,1,1,789,1344,555
12644,1,1,205,1369,1164
12645,1,1,257,1596,1339
12646,0,0,94,0,-94
12647,0,0,37,0,-37
12648,0,0,144,0,-144
12649,0,0,1,0,-1
12650,1,0,234,0,-234
12651,1,0,133,0,-133
12652,0,0,49,0,-49
12653,1,0,125,0,-125
12654,1,1,368,1214,846
12655,1,0,14,0,-14
12656,0,0,1,0,-1
12657,1,1,225,1346,1121
12658,1,1,262,1822,1560
12659,1,1,1285,2296,1011
12660,1,1,358,1233,875
12661,0,0,13,0,-13
12662,1,0,4,0,-4
12663,0,0,120,0,-120
12664,0,0,29,0,-29
12665,1,1,140,1365,1225
12666,0,0,89,0,-89
12667,1,0,12,0,-12
12668,1,1,957,6619,5662
12669,0,0,35,0,-35
12670,1,1,1047,1575,528
12671,0,0,7,0,-7
12672,1,0,30,0,-30
12673,1,1,332,1250,918
12674,1,1,645,1241,596
12675,1,0,25,0,-25
12676,1,1,590,1252,662
12677,1,0,33,0,-33
12678,1,1,660,1539,879
12679,0,0,5,0,-5
12680,1,0,37,0,-37
12681,1,1,812,1296,484
12682,1,0,19,0,-19
12683,1,0,3,0,-3
12684,0,0,152,0,-152
12685,1,0,2,0,-2
12686,1,1,440,1296,856
12687,0,0,43,0,-43
12688,1,0,49,0,-49
12689,1,1,153,1880,1727
12690,1,0,8,0,-8
12691,1,0,60,0,-60
12692,1,1,185,1528,1343
12693,1,0,13,0,-13
12694,1,0,25,0,-25
12695,1,0,72,0,-72
12696,0,0,12,0,-12
12697,1,1,604,1777,1173
12698,1,0,42,0,-42
12699,0,0,63,0,-63
12700,1,1,402,1953,1551
12701,1,1,1214,2275,1061
12702,0,0,36,0,-36
12703,1,0,27,0,-27
12704,0,0,18,0,-18
12705,1,0,6,0,-6
12706,1,1,922,1216,294
12707,0,0,8,0,-8
12708,1,1,73,1269,1196
12709,0,0,10,0,-10
12710,0,0,131,0,-131
12711,1,1,109,2203,2094
12712,0,0,37,0,-37
12713,1,0,13,0,-13
12714,0,0,7,0,-7
12715,1,0,27,0,-27
12716,1,1,345,2590,2245
12717,0,0,52,0,-52
12718,0,0,46,0,-46
12719,1,1,450,2589,2139
12720,0,0,4,0,-4
12721,0,0,62,0,-62
12722,1,1,242,1860,1618
12723,0,0,4,0,-4
12724,1,1,662,1263,601
12725,1,1,1589,1308,-281
12726,0,0,44,0,-44
12727,0,0,17,0,-17
12728,1,1,244,1703,1459
12729,1,0,61,0,-61
12730,1,0,21,0,-21
12731,0,0,12,0,-12
12732,1,0,61,0,-61
12733,0,0,2,0,-2
12734,1,0,0,0,0
12735,0,0,86,0,-86
12736,1,0,34,0,-34
12737,1,1,1000,1269,269
12738,0,0,61,0,-61
12739,1,0,35,0,-35
12740,1,1,2159,1423,-736
12741,1,0,3,0,-3
12742,0,0,215,0,-215
12743,0,0,42,0,-42
12744,0,0,145,0,-145
12745,1,0,29,0,-29
12746,0,0,76,0,-76
12747,0,0,3,0,-3
12748,0,0,44,0,-44
12749,1,1,132,1703,1571
12750,1,0,147,0,-147
12751,1,1,51,1347,1296
12752,1,1,359,1959,1600
12753,1,0,13,0,-13
12754,0,0,75,0,-75
12755,1,0,2,0,-2
12756,1,0,13,0,-13
12757,1,0,202,0,-202
12758,1,1,943,1557,614
12759,1,0,51,0,-51
12760,1,1,135,1308,1173
12761,1,0,10,0,-10
12762,0,0,0,0,0
12763,1,0,108,0,-108
12764,1,1,80,1278,1198
12765,0,0,157,0,-157
12766,0,0,74,0,-74
12767,1,1,1186,1331,145
12768,1,0,45,0,-45
12769,1,1,1529,1280,-249
12770,0,0,30,0,-30
12771,0,0,60,0,-60
12772,1,0,3,0,-3
12773,1,1,241,1320,1079
12774,1,0,116,0,-116
12775,0,0,6,0,-6
12776,0,0,0,0,0
12777,0,0,91,0,-91
12778,1,0,190,0,-190
12779,1,1,307,1206,899
12780,1,1,67,1638,1571
12781,1,0,11,0,-11
12782,0,0,15,0,-15
12783,1,0,28,0,-28
12784,1,1,54,1210,1156
12785,1,0,35,0,-35
12786,1,1,347,1366,1019
12787,1,1,1255,2357,1102
12788,1,0,42,0,-42
12789,0,0,27,0,-27
12790,0,0,20,0,-20
12791,0,0,7,0,-7
12792,0,0,50,0,-50
12793,1,1,206,1257,1051
12794,0,0,17,0,-17
12795,1,1,222,1359,1137
12796,1,0,18,0,-18
12797,1,1,58,1269,1211
12798,1,0,12,0,-12
12799,0,0,19,0,-19
12800,1,1,1965,1309,-656
12801,0,0,31,0,-31
12802,1,1,244,2665,2421
12803,0,0,29,0,-29
12804,0,0,86,0,-86
12805,1,1,715,1200,485
12806,1,0,57,0,-57
12807,1,1,331,1465,1134
12808,0,0,49,0,-49
12809,0,0,24,0,-24
12810,1,0,30,0,-30
12811,1,0,31,0,-31
12812,1,1,133,1217,1084
12813,1,1,186,1258,1072
12814,0,0,81,0,-81
12815,1,0,6,0,-6
12816,1,1,555,1219,664
12817,1,1,195,1311,1116
12818,1,1,448,1513,1065
12819,1,1,331,1241,910
12820,1,1,477,1261,784
12821,1,1,335,1302,967
12822,0,0,15,0,-15
12823,1,0,1,0,-1
12824,0,0,7,0,-7
12825,1,1,697,1541,844
12826,0,0,30,0,-30
12827,0,0,47,0,-47
12828,0,0,45,0,-45
12829,1,0,48,0,-48
12830,0,0,174,0,-174
12831,1,0,24,0,-24
12832,1,0,37,0,-37
12833,1,0,2,0,-2
12834,0,0,29,0,-29
12835,0,0,42,0,-42
12836,1,1,64,1202,1138
12837,0,0,126,0,-126
12838,1,1,833,2493,1660
12839,0,0,1,0,-1
12840,1,0,5,0,-5
12841,0,0,173,0,-173
12842,1,1,108,1968,1860
12843,1,1,464,1204,740
12844,1,0,15,0,-15
12845,1,1,2436,1299,-1137
12846,1,0,10,0,-10
12847,1,0,9,0,-9
12848,0,0,120,0,-120
12849,1,0,42,0,-42
12850,1,0,11,0,-11
12851,1,0,22,0,-22
12852,1,1,1167,2518,1351
12853,1,1,897,1699,802
12854,0,0,111,0,-111
12855,0,0,34,0,-34
12856,0,0,24,0,-24
12857,0,0,14,0,-14
12858,0,0,10,0,-10
12859,1,0,80,0,-80
12860,0,0,26,0,-26
12861,0,0,43,0,-43
12862,1,0,184,0,-184
12863,1,0,7,0,-7
12864,0,0,124,0,-124
12865,1,0,92,0,-92
12866,1,1,92,2179,2087
12867,0,0,5,0,-5
12868,1,0,7,0,-7
12869,0,0,4,0,-4
12870,1,0,7,0,-7
12871,1,0,4,0,-4
12872,1,1,80,1414,1334
12873,1,0,13,0,-13
12874,1,0,84,0,-84
12875,1,0,32,0,-32
12876,1,0,163,0,-163
12877,0,0,22,0,-22
12878,1,1,1337,1284,-53
12879,0,0,35,0,-35
12880,0,0,70,0,-70
12881,0,0,60,0,-60
12882,1,1,37,1363,1326
12883,0,0,21,0,-21
12884,1,0,21,0,-21
12885,0,0,38,0,-38
12886,1,1,202,1282,1080
12887,0,0,302,0,-302
12888,1,1,242,1303,1061
12889,0,0,31,0,-31
12890,0,0,0,0,0
12891,0,0,0,0,0
12892,1,0,74,0,-74
12893,0,0,71,0,-71
12894,1,1,1042,1543,501
12895,1,1,105,1239,1134
12896,1,1,428,1400,972
12897,1,1,193,1236,1043
12898,0,0,75,0,-75
12899,0,0,124,0,-124
12900,0,0,56,0,-56
12901,0,0,0,0,0
12902,1,1,298,1443,1145
12903,0,0,20,0,-20
12904,1,0,45,0,-45
12905,0,0,85,0,-85
12906,1,0,4,0,-4
12907,1,0,77,0,-77
12908,1,1,1198,1549,351
12909,1,1,238,1360,1122
12910,1,1,988,2185,1197
12911,0,0,29,0,-29
12912,1,0,199,0,-199
12913,1,0,127,0,-127
12914,1,1,553,1224,671
12915,0,0,61,0,-61
12916,1,1,453,1582,1129
12917,0,0,2,0,-2
12918,1,0,39,0,-39
12919,1,0,13,0,-13
12920,1,1,844,1400,556
12921,0,0,10,0,-10
12922,1,0,129,0,-129
12923,1,1,970,1436,466
12924,1,1,108,1839,1731
12925,1,1,226,2019,1793
12926,0,0,102,0,-102
12927,1,0,3,0,-3
12928,1,0,197,0,-197
12929,1,1,224,1291,1067
12930,1,0,24,0,-24
12931,0,0,44,0,-44
12932,1,1,307,1264,957
12933,1,0,2,0,-2
12934,1,1,217,2012,1795
12935,0,0,60,0,-60
12936,1,0,13,0,-13
12937,1,0,160,0,-160
12938,1,1,703,1201,498
12939,0,0,58,0,-58
12940,1,0,22,0,-22
12941,1,1,681,1449,768
12942,0,0,32,0,-32
12943,1,0,9,0,-9
12944,0,0,111,0,-111
12945,0,0,1,0,-1
12946,1,0,15,0,-15
12947,1,1,198,1606,1408
12948,0,0,16,0,-16
12949,0,0,20,0,-20
12950,0,0,149,0,-149
12951,1,0,37,0,-37
12952,1,1,329,1388,1059
12953,1,1,811,1672,861
12954,0,0,75,0,-75
12955,1,0,38,0,-38
12956,1,0,41,0,-41
12957,1,1,127,1277,1150
12958,1,1,210,1638,1428
12959,1,0,53,0,-53
12960,1,1,436,2304,1868
12961,1,1,328,1595,1267
12962,1,0,0,0,0
12963,1,1,143,1200,1057
12964,1,1,2243,1608,-635
12965,1,1,110,1211,1101
12966,1,1,664,1824,1160
12967,0,0,22,0,-22
12968,0,0,61,0,-61
12969,1,1,146,1697,1551
12970,0,0,98,0,-98
12971,1,1,840,1703,863
12972,1,0,1,0,-1
12973,0,0,29,0,-29
12974,1,1,783,1419,636
12975,1,0,18,0,-18
12976,1,1,8,1309,1301
12977,0,0,21,0,-21
12978,0,0,98,0,-98
12979,1,1,180,1268,1088
12980,0,0,76,0,-76
12981,0,0,22,0,-22
12982,1,0,195,0,-195
12983,1,1,785,1333,548
12984,1,0,21,0,-21
12985,1,0,28,0,-28
12986,1,0,32,0,-32
12987,1,0,55,0,-55
12988,1,0,47,0,-47
12989,1,1,102,1289,1187
12990,0,0,32,0,-32
12991,1,1,504,1218,714
12992,1,1,500,2151,1651
12993,0,0,42,0,-42
12994,0,0,2,0,-2
12995,1,1,1160,1338,178
12996,0,0,47,0,-47
12997,0,0,0,0,0
12998,0,0,17,0,-17
12999,1,1,70,1720,1650
13000,1,1,170,1249,1079
13001,1,1,15,1856,1841
13002,1,0,17,0,-17
13003,0,0,10,0,-10
13004,0,0,20,0,-20
13005,1,0,49,0,-49
13006,1,0,4,0,-4
13007,1,0,5,0,-5
13008,0,0,66,0,-66
13009,1,0,43,0,-43
13010,1,0,116,0,-116
13011,1,1,636,1316,680
13012,1,0,10,0,-10
13013,0,0,32,0,-32
13014,0,0,29,0,-29
13015,1,0,34,0,-34
13016,1,0,10,0,-10
13017,0,0,146,0,-146
13018,0,0,255,0,-255
13019,1,1,195,1377,1182
13020,1,1,116,3987,3871
13021,1,1,1116,1476,360
13022,1,1,1075,1323,248
13023,1,1,293,1699,1406
13024,1,0,30,0,-30
13025,1,0,100,0,-100
13026,0,0,38,0,-38
13027,1,0,2,0,-2
13028,1,0,57,0,-57
13029,1,1,276,2800,2524
13030,1,1,18,1245,1227
13031,1,0,5,0,-5
13032,1,1,608,1275,667
13033,1,1,87,1409,1322
13034,1,1,1215,1223,8
13035,0,0,46,0,-46
13036,0,0,78,0,-78
13037,1,1,866,1481,615
13038,0,0,56,0,-56
13039,1,1,1172,1618,446
13040,0,0,5,0,-5
13041,0,0,79,0,-79
13042,1,0,5,0,-5
13043,0,0,130,0,-130
13044,0,0,36,0,-36
13045,1,1,283,1772,1489
13046,0,0,4,0,-4
13047,1,1,1098,1322,224
13048,0,0,4,0,-4
13049,1,1,24,1366,1342
13050,1,0,15,0,-15
13051,1,0,17,0,-17
13052,0,0,29,0,-29
13053,0,0,1,0,-1
13054,0,0,140,0,-140
13055,1,0,27,0,-27
13056,1,0,2,0,-2
13057,1,0,20,0,-20
13058,1,1,141,3574,3433
13059,1,1,283,1802,1519
13060,0,0,87,0,-87
13061,0,0,29,0,-29
13062,1,0,173,0,-173
13063,0,0,27,0,-27
13064,0,0,83,0,-83
13065,0,0,54,0,-54
13066,1,1,309,1214,905
13067,1,0,31,0,-31
13068,0,0,52,0,-52
13069,1,0,35,0,-35
13070,0,0,30,0,-30
13071,1,0,55,0,-55
13072,1,1,216,1403,1187
13073,1,1,271,1475,1204
13074,1,1,789,1501,712
13075,1,1,146,1534,1388
13076,0,0,13,0,-13
13077,0,0,191,0,-191
13078,1,1,375,1481,1106
13079,1,1,403,1293,890
13080,0,0,54,0,-54
13081,1,0,23,0,-23
13082,1,0,71,0,-71
13083,0,0,33,0,-33
13084,0,0,54,0,-54
13085,0,0,59,0,-59
13086,0,0,157,0,-157
13087,1,1,212,1763,1551
13088,0,0,94,0,-94
13089,1,0,111,0,-111
13090,1,1,7,1401,1394
13091,0,0,468,0,-468
13092,1,0,104,0,-104
13093,1,0,11,0,-11
13094,0,0,27,0,-27
13095,1,1,397,1412,1015
13096,1,0,166,0,-166
13097,1,0,77,0,-77
13098,1,1,212,1251,1039
13099,0,0,166,0,-166
13100,1,1,136,1561,1425
13101,1,0,47,0,-47
13102,0,0,23,0,-23
13103,1,1,54,1374,1320
13104,1,1,301,1664,1363
13105,1,1,485,1484,999
13106,1,0,10,0,-10
13107,0,0,2,0,-2
13108,0,0,38,0,-38
13109,0,0,43,0,-43
13110,1,0,95,0,-95
13111,1,0,35,0,-35
13112,1,0,9,0,-9
13113,0,0,47,0,-47
13114,1,0,54,0,-54
13115,0,0,11,0,-11
13116,0,0,10,0,-10
13117,0,0,59,0,-59
13118,1,0,24,0,-24
13119,0,0,261,0,-261
13120,0,0,1,0,-1
13121,0,0,97,0,-97
13122,1,1,376,1278,902
13123,0,0,58,0,-58
13124,1,1,181,1650,1469
13125,1,0,222,0,-222
13126,0,0,44,0,-44
13127,1,1,1044,1492,448
13128,1,0,3,0,-3
13129,0,0,32,0,-32
13130,1,1,321,1605,1284
13131,1,1,620,1790,1170
13132,1,0,43,0,-43
13133,0,0,7,0,-7
13134,1,0,274,0,-274
13135,0,0,18,0,-18
13136,1,0,23,0,-23
13137,1,1,98,1528,1430
13138,0,0,3,0,-3
13139,0,0,21,0,-21
13140,1,0,148,0,-148
13141,1,1,540,2307,1767
13142,0,0,82,0,-82
13143,1,0,34,0,-34
13144,0,0,17,0,-17
13145,1,0,62,0,-62
13146,1,0,48,0,-48
13147,1,1,560,1780,1220
13148,1,1,472,1419,947
13149,0,0,0,0,0
13150,0,0,31,0,-31
13151,0,0,29,0,-29
13152,1,0,30,0,-30
13153,1,1,1274,1300,26
13154,1,1,1194,1595,401
13155,0,0,46,0,-46
13156,1,0,28,0,-28
13157,0,0,64,0,-64
13158,1,1,191,1207,1016
13159,0,0,11,0,-11
13160,0,0,8,0,-8
13161,0,0,94,0,-94
13162,1,1,633,2537,1904
13163,1,1,67,1408,1341
13164,0,0,7,0,-7
13165,0,0,5,0,-5
13166,0,0,111,0,-111
13167,1,1,77,1229,1152
13168,1,0,71,0,-71
13169,0,0,26,0,-26
13170,1,1,104,1781,1677
13171,1,1,276,1491,1215
13172,0,0,34,0,-34
13173,1,1,823,1311,488
13174,1,1,554,1439,885
13175,1,1,667,1526,859
13176,1,0,0,0,0
13177,1,0,18,0,-18
13178,0,0,111,0,-111
13179,0,0,166,0,-166
13180,1,0,13,0,-13
13181,1,1,622,1887,1265
13182,0,0,225,0,-225
13183,0,0,26,0,-26
13184,1,1,297,1945,1648
13185,0,0,61,0,-61
13186,0,0,23,0,-23
13187,0,0,14,0,-14
13188,1,0,17,0,-17
13189,1,0,19,0,-19
13190,1,0,106,0,-106
13191,1,1,1185,1539,354
13192,1,0,65,0,-65
13193,0,0,52,0,-52
13194,1,0,322,0,-322
13195,1,1,248,1483,1235
13196,1,1,1205,1215,10
13197,0,0,27,0,-27
13198,1,1,298,1537,1239
13199,1,1,779,1452,673
13200,0,0,38,0,-38
13201,0,0,16,0,-16
13202,0,0,8,0,-8
13203,0,0,60,0,-60
13204,1,1,1397,1594,197
13205,1,0,32,0,-32
13206,0,0,55,0,-55
13207,0,0,47,0,-47
13208,1,0,69,0,-69
13209,1,0,35,0,-35
13210,1,0,25,0,-25
13211,1,1,343,2536,2193
13212,0,0,76,0,-76
13213,0,0,19,0,-19
13214,1,1,86,1329,1243
13215,1,0,41,0,-41
13216,1,1,212,1390,1178
13217,0,0,41,0,-41
13218,1,1,719,1403,684
13219,1,0,24,0,-24
13220,1,0,67,0,-67
13221,0,0,116,0,-116
13222,1,0,9,0,-9
13223,0,0,22,0,-22
13224,1,0,19,0,-19
13225,0,0,68,0,-68
13226,0,0,30,0,-30
13227,1,0,168,0,-168
13228,0,0,79,0,-79
13229,0,0,45,0,-45
13230,1,0,132,0,-132
13231,0,0,62,0,-62
13232,1,0,145,0,-145
13233,0,0,109,0,-109
13234,1,1,780,1495,715
13235,1,1,181,1264,1083
13236,1,0,38,0,-38
13237,1,0,8,0,-8
13238,0,0,39,0,-39
13239,1,1,94,1683,1589
13240,0,0,74,0,-74
13241,1,0,38,0,-38
13242,0,0,28,0,-28
13243,0,0,222,0,-222
13244,1,1,174,2150,1976
13245,1,0,29,0,-29
13246,1,1,563,1674,1111
13247,0,0,94,0,-94
13248,1,0,75,0,-75
13249,1,0,5,0,-5
13250,1,1,555,1763,1208
13251,1,1,263,1348,1085
13252,1,1,732,1523,791
13253,0,0,89,0,-89
13254,1,1,309,1229,920
13255,0,0,13,0,-13
13256,1,1,1768,1269,-499
13257,1,1,296,1541,1245
13258,1,0,14,0,-14
13259,0,0,9,0,-9
13260,0,0,17,0,-17
13261,0,0,34,0,-34
13262,1,1,1264,1511,247
13263,0,0,255,0,-255
13264,0,0,7,0,-7
13265,0,0,75,0,-75
13266,0,0,9,0,-9
13267,1,1,29,1395,1366
13268,0,0,15,0,-15
13269,1,0,6,0,-6
13270,1,0,67,0,-67
13271,1,0,62,0,-62
13272,0,0,59,0,-59
13273,1,0,65,0,-65
13274,1,0,47,0,-47
13275,1,1,577,1394,817
13276,1,0,29,0,-29
13277,1,1,91,1228,1137
13278,1,1,930,1299,369
13279,1,1,783,1229,446
13280,0,0,58,0,-58
13281,1,1,396,1467,1071
13282,1,0,11,0,-11
13283,0,0,38,0,-38
13284,1,0,44,0,-44
13285,1,1,724,1228,504
13286,1,1,345,1375,1030
13287,1,0,18,0,-18
13288,1,1,184,1430,1246
13289,1,1,1265,1574,309
13290,0,0,10,0,-10
13291,0,0,15,0,-15
13292,0,0,12,0,-12
13293,1,1,145,1847,1702
13294,1,0,85,0,-85
13295,1,1,100,1282,1182
13296,0,0,19,0,-19
13297,1,1,265,1846,1581
13298,0,0,49,0,-49
13299,0,0,95,0,-95
13300,1,0,63,0,-63
13301,0,0,53,0,-53
13302,0,0,4,0,-4
13303,1,0,99,0,-99
13304,1,0,45,0,-45
13305,1,0,67,0,-67
13306,0,0,57,0,-57
13307,0,0,13,0,-13
13308,1,0,87,0,-87
13309,0,0,201,0,-201
13310,0,0,17,0,-17
13311,1,0,15,0,-15
13312,1,1,344,1449,1105
13313,1,0,21,0,-21
13314,1,1,837,1876,1039
13315,0,0,28,0,-28
13316,1,1,1128,3556,2428
13317,1,1,178,1679,1501
13318,1,1,908,2282,1374
13319,1,1,52,2358,2306
13320,1,1,86,1729,1643
13321,1,1,1837,1572,-265
13322,1,0,67,0,-67
13323,0,0,21,0,-21
13324,1,1,169,3765,3596
13325,0,0,28,0,-28
13326,1,1,1070,1290,220
13327,1,0,134,0,-134
13328,0,0,16,0,-16
13329,0,0,123,0,-123
13330,1,0,34,0,-34
13331,1,1,1138,1202,64
13332,1,1,547,1716,1169
13333,1,1,83,1320,1237
13334,1,0,22,0,-22
13335,0,0,3,0,-3
13336,1,0,19,0,-19
13337,1,0,30,0,-30
13338,1,0,23,0,-23
13339,1,1,819,2095,1276
13340,1,0,40,0,-40
13341,0,0,20,0,-20
13342,1,0,12,0,-12
13343,1,1,1638,1395,-243
13344,1,1,210,1260,1050
13345,1,0,20,0,-20
13346,1,0,213,0,-213
13347,0,0,43,0,-43
13348,1,1,137,1431,1294
13349,1,1,1119,1726,607
13350,1,0,110,0,-110
13351,1,1,1188,1453,265
13352,1,0,74,0,-74
13353,1,0,23,0,-23
13354,0,0,72,0,-72
13355,1,0,7,0,-7
13356,1,1,840,1357,517
13357,1,1,137,1252,1115
13358,0,0,156,0,-156
13359,0,0,49,0,-49
13360,1,1,749,1251,502
13361,0,0,7,0,-7
13362,1,0,79,0,-79
13363,0,0,36,0,-36
13364,0,0,6,0,-6
13365,0,0,182,0,-182
13366,1,1,124,1289,1165
13367,1,0,27,0,-27
13368,0,0,142,0,-142
13369,0,0,62,0,-62
13370,1,0,113,0,-113
13371,0,0,65,0,-65
13372,1,1,345,1479,1134
13373,1,0,33,0,-33
13374,0,0,32,0,-32
13375,1,1,208,1552,1344
13376,1,0,20,0,-20
13377,0,0,13,0,-13
13378,0,0,60,0,-60
13379,0,0,51,0,-51
13380,0,0,8,0,-8
13381,1,0,249,0,-249
13382,1,0,79,0,-79
13383,1,1,725,1340,615
13384,0,0,38,0,-38
13385,0,0,47,0,-47
13386,0,0,36,0,-36
13387,1,0,30,0,-30
13388,1,0,34,0,-34
13389,0,0,25,0,-25
13390,1,1,471,1390,919
13391,0,0,10,0,-10
13392,1,0,0,0,0
13393,1,1,894,3033,2139
13394,0,0,119,0,-119
13395,1,1,733,1740,1007
13396,1,1,45,1385,1340
13397,1,1,132,1321,1189
13398,0,0,13,0,-13
13399,0,0,17,0,-17
13400,1,0,57,0,-57
13401,0,0,95,0,-95
13402,0,0,28,0,-28
13403,1,1,121,1878,1757
13404,0,0,42,0,-42
13405,1,1,1010,1334,324
13406,0,0,56,0,-56
13407,1,0,52,0,-52
13408,1,1,313,1881,1568
13409,1,0,116,0,-116
13410,0,0,84,0,-84
13411,1,1,184,1527,1343
13412,1,1,447,1820,1373
13413,1,1,1373,2525,1152
13414,0,0,36,0,-36
13415,1,1,2136,1426,-710
13416,1,1,250,1719,1469
13417,1,0,31,0,-31
13418,0,0,9,0,-9
13419,1,1,392,1227,835
13420,1,0,20,0,-20
13421,1,1,774,1512,738
13422,0,0,51,0,-51
13423,1,1,222,2081,1859
13424,0,0,83,0,-83
13425,1,0,97,0,-97
13426,1,1,644,1537,893
13427,1,1,321,1358,1037
13428,1,1,714,1316,602
13429,1,0,75,0,-75
13430,0,0,22,0,-22
13431,1,0,21,0,-21
13432,0,0,1,0,-1
13433,0,0,41,0,-41
13434,1,0,89,0,-89
13435,0,0,45,0,-45
13436,0,0,6,0,-6
13437,1,0,8,0,-8
13438,0,0,25,0,-25
13439,1,1,1087,1290,203
13440,1,0,29,0,-29
13441,0,0,24,0,-24
13442,1,1,420,1330,910
13443,0,0,185,0,-185
13444,1,1,541,1706,1165
13445,1,0,80,0,-80
13446,0,0,79,0,-79
13447,0,0,29,0,-29
13448,0,0,56,0,-56
13449,0,0,11,0,-11
13450,0,0,36,0,-36
13451,0,0,15,0,-15
13452,0,0,5,0,-5
13453,1,0,130,0,-130
13454,1,0,113,0,-113
13455,1,0,52,0,-52
13456,0,0,75,0,-75
13457,0,0,24,0,-24
13458,1,0,46,0,-46
13459,1,0,50,0,-50
13460,1,0,49,0,-49
13461,1,1,250,1343,1093
13462,1,1,832,1710,878
13463,1,0,23,0,-23
13464,1,1,178,1350,1172
13465,1,0,32,0,-32
13466,0,0,125,0,-125
13467,0,0,71,0,-71
13468,0,0,79,0,-79
13469,1,0,49,0,-49
13470,1,1,127,2296,2169
13471,1,0,30,0,-30
13472,1,0,13,0,-13
13473,1,0,153,0,-153
13474,1,1,463,1259,796
13475,0,0,6,0,-6
13476,1,1,493,1591,1098
13477,1,0,73,0,-73
13478,1,1,284,1554,1270
13479,1,1,2683,2635,-48
13480,1,0,66,0,-66
13481,1,1,511,1290,779
13482,1,0,258,0,-258
13483,1,0,49,0,-49
13484,1,0,73,0,-73
13485,0,0,40,0,-40
13486,1,1,328,1299,971
13487,0,0,38,0,-38
13488,0,0,16,0,-16
13489,1,0,28,0,-28
13490,1,0,75,0,-75
13491,1,0,33,0,-33
13492,0,0,16,0,-16
13493,1,0,16,0,-16
13494,1,0,21,0,-21
13495,1,1,1310,1738,428
13496,0,0,62,0,-62
13497,1,1,785,2250,1465
13498,0,0,44,0,-44
13499,1,1,772,1912,1140
13500,1,0,67,0,-67
13501,0,0,13,0,-13
13502,1,1,330,1308,978
13503,1,1,37,1568,1531
13504,0,0,18,0,-18
13505,0,0,34,0,-34
13506,1,0,132,0,-132
13507,0,0,47,0,-47
13508,0,0,7,0,-7
13509,1,0,30,0,-30
13510,1,0,30,0,-30
13511,1,1,178,1422,1244
13512,1,1,119,1246,1127
13513,1,1,255,1410,1155
13514,1,0,31,0,-31
13515,1,0,101,0,-101
13516,0,0,37,0,-37
13517,1,0,0,0,0
13518,1,0,194,0,-194
13519,1,0,18,0,-18
13520,0,0,11,0,-11
13521,1,1,264,1975,1711
13522,1,0,83,0,-83
13523,0,0,47,0,-47
13524,0,0,56,0,-56
13525,1,1,481,1365,884
13526,1,0,94,0,-94
13527,1,0,25,0,-25
13528,1,0,134,0,-134
13529,0,0,6,0,-6
13530,1,1,114,1202,1088
13531,1,1,70,3001,2931
13532,1,0,3,0,-3
13533,1,0,51,0,-51
13534,0,0,94,0,-94
13535,1,0,37,0,-37
13536,0,0,18,0,-18
13537,0,0,6,0,-6
13538,0,0,3,0,-3
13539,1,1,128,1475,1347
13540,0,0,12,0,-12
13541,1,1,247,1639,1392
13542,1,1,466,1298,832
13543,1,0,58,0,-58
13544,1,1,777,1457,680
13545,1,0,3,0,-3
13546,1,1,361,1268,907
13547,1,0,64,0,-64
13548,1,0,35,0,-35
13549,1,1,549,2516,1967
13550,0,0,33,0,-33
13551,1,1,493,1351,858
13552,1,0,34,0,-34
13553,0,0,7,0,-7
13554,1,1,511,2170,1659
13555,0,0,29,0,-29
13556,0,0,0,0,0
13557,1,1,58,2035,1977
13558,0,0,15,0,-15
13559,1,1,463,1426,963
13560,1,1,75,1540,1465
13561,1,1,1043,1332,289
13562,1,0,57,0,-57
13563,0,0,68,0,-68
13564,0,0,190,0,-190
13565,1,0,0,0,0
13566,0,0,28,0,-28
13567,1,0,91,0,-91
13568,0,0,69,0,-69
13569,1,1,893,1504,611
13570,1,0,40,0,-40
13571,0,0,24,0,-24
13572,1,1,216,1229,1013
13573,1,0,48,0,-48
13574,0,0,59,0,-59
13575,1,0,52,0,-52
13576,0,0,41,0,-41
13577,1,0,5,0,-5
13578,0,0,44,0,-44
13579,0,0,92,0,-92
13580,1,0,39,0,-39
13581,0,0,50,0,-50
13582,1,0,66,0,-66
13583,0,0,6,0,-6
13584,1,1,354,1948,1594
13585,1,1,378,1803,1425
13586,0,0,62,0,-62
13587,1,0,18,0,-18
13588,1,1,44,1480,1436
13589,1,1,618,1236,618
13590,1,0,74,0,-74
13591,1,1,1302,1721,419
13592,0,0,11,0,-11
13593,1,0,36,0,-36
13594,0,0,10,0,-10
13595,0,0,4,0,-4
13596,1,1,194,1245,1051
13597,1,1,474,1409,935
13598,1,0,85,0,-85
13599,1,1,203,1360,1157
13600,1,1,37,1306,1269
13601,1,1,126,2622,2496
13602,0,0,31,0,-31
13603,1,0,82,0,-82
13604,1,1,610,2146,1536
13605,1,1,229,1677,1448
13606,1,1,912,1363,451
13607,0,0,35,0,-35
13608,0,0,23,0,-23
13609,0,0,28,0,-28
13610,1,0,15,0,-15
13611,0,0,23,0,-23
13612,1,0,47,0,-47
13613,0,0,24,0,-24
13614,1,1,166,1921,1755
13615,0,0,128,0,-128
13616,0,0,25,0,-25
13617,1,0,21,0,-21
13618,1,0,4,0,-4
13619,1,0,103,0,-103
13620,0,0,107,0,-107
13621,1,1,313,1208,895
13622,0,0,116,0,-116
13623,0,0,13,0,-13
13624,1,0,93,0,-93
13625,1,1,2311,1443,-868
13626,1,0,12,0,-12
13627,0,0,73,0,-73
13628,1,0,15,0,-15
13629,0,0,66,0,-66
13630,1,1,345,1550,1205
13631,1,1,1525,1243,-282
13632,0,0,27,0,-27
13633,0,0,95,0,-95
13634,1,1,487,1230,743
13635,1,1,532,1482,950
13636,1,1,525,1388,863
13637,1,0,73,0,-73
13638,1,0,46,0,-46
13639,0,0,4,0,-4
13640,1,0,47,0,-47
13641,0,0,111,0,-111
13642,0,0,43,0,-43
13643,0,0,101,0,-101
13644,1,1,268,1520,1252
13645,1,1,744,1464,720
13646,0,0,17,0,-17
13647,1,1,180,2159,1979
13648,1,0,27,0,-27
13649,0,0,43,0,-43
13650,0,0,9,0,-9
13651,0,0,59,0,-59
13652,1,0,29,0,-29
13653,0,0,47,0,-47
13654,1,1,79,1761,1682
13655,1,0,73,0,-73
13656,0,0,22,0,-22
13657,0,0,23,0,-23
13658,1,1,602,1251,649
13659,0,0,69,0,-69
13660,1,1,50,1303,1253
13661,1,0,3,0,-3
13662,0,0,109,0,-109
13663,0,0,17,0,-17
13664,0,0,15,0,-15
13665,1,1,34,1332,1298
13666,1,1,213,1427,1214
13667,1,1,929,1217,288
13668,1,0,60,0,-60
13669,0,0,51,0,-51
13670,0,0,5,0,-5
13671,0,0,27,0,-27
13672,0,0,8,0,-8
13673,1,1,90,1884,1794
13674,1,0,38,0,-38
13675,1,1,574,1557,983
13676,0,0,7,0,-7
13677,0,0,28,0,-28
13678,0,0,21,0,-21
13679,1,0,11,0,-11
13680,0,0,5,0,-5
13681,1,1,1808,1383,-425
13682,0,0,68,0,-68
13683,0,0,81,0,-81
13684,1,0,81,0,-81
13685,0,0,23,0,-23
13686,0,0,41,0,-41
13687,1,1,538,1526,988
13688,1,0,5,0,-5
13689,1,0,28,0,-28
13690,1,0,188,0,-188
13691,0,0,58,0,-58
13692,0,0,49,0,-49
13693,1,1,566,1358,792
13694,1,0,15,0,-15
13695,0,0,3,0,-3
13696,1,0,191,0,-191
13697,1,1,496,2069,1573
13698,1,1,133,1386,1253
13699,0,0,41,0,-41
13700,0,0,42,0,-42
13701,0,0,117,0,-117
13702,1,0,62,0,-62
13703,1,0,113,0,-113
13704,1,1,584,4151,3567
13705,0,0,0,0,0
13706,1,1,312,2137,1825
13707,1,0,17,0,-17
13708,1,1,564,1288,724
13709,0,0,0,0,0
13710,0,0,0,0,0
13711,0,0,60,0,-60
13712,1,0,86,0,-86
13713,1,1,400,1595,1195
13714,1,1,171,1688,1517
13715,1,1,2030,1613,-417
13716,1,0,2,0,-2
13717,0,0,24,0,-24
13718,0,0,40,0,-40
13719,1,1,463,2287,1824
13720,1,1,328,1356,1028
13721,1,1,682,1603,921
13722,1,0,42,0,-42
13723,0,0,40,0,-40
13724,1,1,276,1246,970
13725,0,0,41,0,-41
13726,1,1,275,1514,1239
13727,0,0,73,0,-73
13728,1,0,13,0,-13
13729,1,0,3,0,-3
13730,1,1,590,1341,751
13731,1,0,5,0,-5
13732,0,0,142,0,-142
13733,1,1,300,1260,960
13734,1,1,1229,1362,133
13735,1,1,2042,1657,-385
13736,0,0,101,0,-101
13737,0,0,34,0,-34
13738,1,1,1674,1878,204
13739,0,0,15,0,-15
13740,1,1,646,1295,649
13741,1,0,156,0,-156
13742,0,0,216,0,-216
13743,0,0,12,0,-12
13744,1,0,78,0,-78
13745,1,0,15,0,-15
13746,1,1,2009,1523,-486
13747,1,0,38,0,-38
13748,0,0,30,0,-30
13749,0,0,13,0,-13
13750,0,0,80,0,-80
13751,1,0,352,0,-352
13752,0,0,96,0,-96
13753,1,0,19,0,-19
13754,1,0,5,0,-5
13755,1,1,427,1442,1015
13756,0,0,91,0,-91
13757,0,0,21,0,-21
13758,1,0,115,0,-115
13759,1,0,5,0,-5
13760,0,0,51,0,-51
13761,1,0,8,0,-8
13762,1,0,19,0,-19
13763,1,0,26,0,-26
13764,1,0,8,0,-8
13765,0,0,23,0,-23
13766,1,0,48,0,-48
13767,1,0,74,0,-74
13768,1,0,207,0,-207
13769,1,1,456,1333,877
13770,1,0,10,0,-10
13771,0,0,24,0,-24
13772,1,1,212,1419,1207
13773,1,0,4,0,-4
13774,1,0,32,0,-32
13775,0,0,257,0,-257
13776,1,0,39,0,-39
13777,1,0,41,0,-41
13778,0,0,58,0,-58
13779,0,0,28,0,-28
13780,1,0,59,0,-59
13781,1,0,124,0,-124
13782,1,1,80,2272,2192
13783,0,0,27,0,-27
13784,1,0,10,0,-10
13785,1,0,79,0,-79
13786,1,1,34,1399,1365
13787,0,0,18,0,-18
13788,0,0,36,0,-36
13789,0,0,98,0,-98
13790,0,0,6,0,-6
13791,1,1,1032,1231,199
13792,0,0,95,0,-95
13793,1,1,813,1375,562
13794,1,0,62,0,-62
13795,1,1,585,1546,961
13796,1,1,374,1311,937
13797,1,1,270,2212,1942
13798,0,0,56,0,-56
13799,1,1,1214,1504,290
13800,1,0,72,0,-72
13801,0,0,112,0,-112
13802,0,0,21,0,-21
13803,1,1,361,1261,900
13804,1,0,8,0,-8
13805,0,0,22,0,-22
13806,0,0,90,0,-90
13807,1,1,235,2675,2440
13808,1,0,35,0,-35
13809,0,0,113,0,-113
13810,1,1,27,1207,1180
13811,1,1,1009,2330,1321
13812,0,0,20,0,-20
13813,1,0,55,0,-55
13814,0,0,82,0,-82
13815,0,0,70,0,-70
13816,1,1,154,1570,1416
13817,1,1,1059,1911,852
13818,1,0,10,0,-10
13819,0,0,80,0,-80
13820,1,0,45,0,-45
13821,0,0,5,0,-5
13822,1,0,121,0,-121
13823,0,0,63,0,-63
13824,0,0,107,0,-107
13825,1,1,553,1506,953
13826,0,0,60,0,-60
13827,0,0,35,0,-35
13828,1,0,30,0,-30
13829,0,0,15,0,-15
13830,0,0,22,0,-22
13831,1,0,29,0,-29
13832,0,0,58,0,-58
13833,1,1,303,1611,1308
13834,1,1,97,1326,1229
13835,0,0,75,0,-75
13836,1,0,59,0,-59
13837,1,1,457,1273,816
13838,1,0,72,0,-72
13839,0,0,138,0,-138
13840,0,0,31,0,-31
13841,1,1,216,1431,1215
13842,1,0,11,0,-11
13843,1,0,3,0,-3
13844,1,1,136,1622,1486
13845,0,0,64,0,-64
13846,1,0,3,0,-3
13847,1,0,4,0,-4
13848,1,0,87,0,-87
13849,1,1,423,1541,1118
13850,1,0,61,0,-61
13851,0,0,102,0,-102
13852,1,0,7,0,-7
13853,1,1,47,3017,2970
13854,0,0,16,0,-16
13855,1,1,274,1401,1127
13856,0,0,17,0,-17
13857,1,0,60,0,-60
13858,1,1,125,1268,1143
13859,1,1,53,1555,1502
13860,1,1,1836,1352,-484
13861,1,0,4,0,-4
13862,1,1,303,2348,2045
13863,0,0,3,0,-3
13864,1,1,995,2105,1110
13865,1,1,1269,2360,1091
13866,0,0,23,0,-23
13867,1,0,53,0,-53
13868,0,0,9,0,-9
13869,0,0,91,0,-91
13870,1,0,173,0,-173
13871,0,0,145,0,-145
13872,0,0,64,0,-64
13873,1,1,853,1304,451
13874,0,0,44,0,-44
13875,1,0,8,0,-8
13876,1,0,5,0,-5
13877,1,1,676,1710,1034
13878,0,0,14,0,-14
13879,1,0,2,0,-2
13880,1,1,228,1344,1116
13881,0,0,7,0,-7
13882,0,0,1,0,-1
13883,1,1,1426,1311,-115
13884,1,0,56,0,-56
13885,1,0,55,0,-55
13886,1,1,57,1918,1861
13887,1,0,51,0,-51
13888,1,0,128,0,-128
13889,0,0,19,0,-19
13890,1,1,595,1217,622
13891,1,0,14,0,-14
13892,1,1,800,1745,945
13893,1,1,856,1340,484
13894,1,0,7,0,-7
13895,0,0,37,0,-37
13896,0,0,21,0,-21
13897,0,0,17,0,-17
13898,0,0,90,0,-90
13899,0,0,36,0,-36
13900,1,1,895,1326,431
13901,1,1,148,1457,1309
13902,0,0,41,0,-41
13903,1,0,10,0,-10
13904,0,0,54,0,-54
13905,1,0,4,0,-4
13906,0,0,51,0,-51
13907,1,1,384,1224,840
13908,1,1,135,1543,1408
13909,0,0,50,0,-50
13910,1,1,138,1751,1613
13911,0,0,27,0,-27
13912,0,0,0,0,0
13913,1,0,37,0,-37
13914,1,0,55,0,-55
13915,1,1,1205,1287,82
13916,0,0,3,0,-3
13917,0,0,11,0,-11
13918,1,0,10,0,-10
13919,0,0,45,0,-45
13920,1,1,553,1769,1216
13921,0,0,9,0,-9
13922,1,1,256,1326,1070
13923,0,0,2,0,-2
13924,1,1,534,1490,956
13925,1,0,91,0,-91
13926,0,0,15,0,-15
13927,1,1,3748,1266,-2482
13928,1,0,43,0,-43
13929,0,0,64,0,-64
13930,1,1,1732,1393,-339
13931,0,0,57,0,-57
13932,1,0,19,0,-19
13933,1,1,28,1219,1191
13934,1,0,60,0,-60
13935,0,0,38,0,-38
13936,1,0,34,0,-34
13937,0,0,46,0,-46
13938,0,0,14,0,-14
13939,0,0,39,0,-39
13940,1,1,540,1489,949
13941,0,0,18,0,-18
13942,1,0,22,0,-22
13943,1,0,25,0,-25
13944,0,0,22,0,-22
13945,0,0,103,0,-103
13946,0,0,55,0,-55
13947,0,0,61,0,-61
13948,1,0,65,0,-65
13949,1,1,108,2438,2330
13950,0,0,21,0,-21
13951,0,0,7,0,-7
13952,1,0,1,0,-1
13953,0,0,9,0,-9
13954,1,1,536,2155,1619
13955,1,1,2543,1741,-802
13956,1,1,955,1655,700
13957,0,0,49,0,-49
13958,0,0,16,0,-16
13959,1,0,288,0,-288
13960,1,1,51,1476,1425
13961,1,0,1,0,-1
13962,1,0,21,0,-21
13963,1,1,259,1362,1103
13964,1,1,169,1764,1595
13965,0,0,95,0,-95
13966,0,0,32,0,-32
13967,1,0,6,0,-6
13968,1,1,134,1214,1080
13969,1,0,153,0,-153
13970,0,0,73,0,-73
13971,0,0,1,0,-1
13972,0,0,97,0,-97
13973,0,0,44,0,-44
13974,0,0,85,0,-85
13975,0,0,21,0,-21
13976,1,0,94,0,-94
13977,1,0,22,0,-22
13978,1,0,3,0,-3
13979,1,0,22,0,-22
13980,1,1,960,1488,528
13981,0,0,30,0,-30
13982,0,0,8,0,-8
13983,1,0,44,0,-44
13984,1,0,56,0,-56
13985,1,0,133,0,-133
13986,1,1,271,1215,944
13987,0,0,85,0,-85
13988,1,0,36,0,-36
13989,1,0,115,0,-115
13990,1,1,431,1538,1107
13991,0,0,16,0,-16
13992,1,0,3,0,-3
13993,0,0,35,0,-35
13994,0,0,6,0,-6
13995,1,1,909,1524,615
13996,1,0,30,0,-30
13997,1,1,174,3177,3003
13998,1,1,198,1611,1413
13999,1,0,14,0,-14
14000,1,1,380,1437,1057
14001,1,0,18,0,-18
14002,1,1,316,1770,1454
14003,0,0,57,0,-57
14004,1,1,135,1461,1326
14005,1,0,98,0,-98
14006,1,1,87,2024,1937
14007,1,0,2,0,-2
14008,1,1,1236,1268,32
14009,1,1,203,1427,1224
14010,1,1,418,1374,956
14011,1,1,149,1212,1063
14012,1,0,80,0,-80
14013,1,0,30,0,-30
14014,1,0,20,0,-20
14015,1,0,51,0,-51
14016,1,0,54,0,-54
14017,0,0,45,0,-45
14018,1,0,85,0,-85
14019,0,0,77,0,-77
14020,1,1,13,1328,1315
14021,0,0,212,0,-212
14022,1,0,5,0,-5
14023,1,1,837,4075,3238
14024,0,0,51,0,-51
14025,0,0,248,0,-248
14026,0,0,8,0,-8
14027,1,1,981,5276,4295
14028,0,0,166,0,-166
14029,0,0,4,0,-4
14030,0,0,43,0,-43
14031,0,0,75,0,-75
14032,1,1,275,2226,1951
14033,0,0,10,0,-10
14034,1,1,717,1488,771
14035,1,0,71,0,-71
14036,1,0,92,0,-92
14037,0,0,10,0,-10
14038,0,0,216,0,-216
14039,1,0,21,0,-21
14040,1,1,204,1370,1166
14041,0,0,26,0,-26
14042,1,1,111,1270,1159
14043,1,1,506,2051,1545
14044,1,0,6,0,-6
14045,1,0,84,0,-84
14046,0,0,28,0,-28
14047,1,0,2,0,-2
14048,1,0,22,0,-22
14049,0,0,32,0,-32
14050,0,0,47,0,-47
14051,0,0,87,0,-87
14052,1,1,648,1335,687
14053,1,1,81,1583,1502
14054,0,0,40,0,-40
14055,1,0,95,0,-95
14056,1,1,502,1206,704
14057,1,0,110,0,-110
14058,1,0,31,0,-31
14059,0,0,37,0,-37
14060,0,0,112,0,-112
14061,1,1,405,1792,1387
14062,1,0,27,0,-27
14063,0,0,16,0,-16
14064,0,0,18,0,-18
14065,1,1,302,1608,1306
14066,1,1,249,1536,1287
14067,0,0,1,0,-1
14068,1,0,19,0,-19
14069,0,0,57,0,-57
14070,1,1,676,2312,1636
14071,0,0,66,0,-66
14072,0,0,43,0,-43
14073,0,0,24,0,-24
14074,0,0,9,0,-9
14075,1,0,133,0,-133
14076,0,0,3,0,-3
14077,1,0,1,0,-1
14078,0,0,22,0,-22
14079,0,0,9,0,-9
14080,1,1,130,1521,1391
14081,1,0,27,0,-27
14082,1,0,53,0,-53
14083,0,0,6,0,-6
14084,0,0,104,0,-104
14085,1,1,874,1553,679
14086,0,0,3,0,-3
14087,1,0,25,0,-25
14088,0,0,51,0,-51
14089,0,0,15,0,-15
14090,0,0,81,0,-81
14091,1,0,77,0,-77
14092,0,0,25,0,-25
14093,1,0,40,0,-40
14094,1,0,144,0,-144
14095,1,1,70,1651,1581
14096,1,1,86,2592,2506
14097,1,1,232,2414,2182
14098,1,1,551,1319,768
14099,1,0,21,0,-21
14100,0,0,54,0,-54
14101,0,0,166,0,-166
14102,0,0,64,0,-64
14103,0,0,39,0,-39
14104,1,0,6,0,-6
14105,1,1,578,1591,1013
14106,1,0,41,0,-41
14107,1,1,514,1313,799
14108,0,0,111,0,-111
14109,1,0,19,0,-19
14110,1,0,74,0,-74
14111,1,0,98,0,-98
14112,0,0,7,0,-7
14113,0,0,0,0,0
14114,1,1,221,1237,1016
14115,0,0,48,0,-48
14116,1,0,17,0,-17
14117,0,0,88,0,-88
14118,1,1,467,1939,1472
14119,1,0,46,0,-46
14120,0,0,23,0,-23
14121,0,0,9,0,-9
14122,0,0,12,0,-12
14123,1,1,76,1967,1891
14124,0,0,52,0,-52
14125,1,1,162,1570,1408
14126,1,1,395,3027,2632
14127,0,0,100,0,-100
14128,0,0,127,0,-127
14129,0,0,1,0,-1
14130,0,0,110,0,-110
14131,1,1,469,2434,1965
14132,0,0,138,0,-138
14133,0,0,13,0,-13
14134,0,0,3,0,-3
14135,0,0,65,0,-65
14136,0,0,62,0,-62
14137,0,0,8,0,-8
14138,1,1,788,1573,785
14139,0,0,50,0,-50
14140,1,1,91,1345,1254
14141,1,0,41,0,-41
14142,0,0,54,0,-54
14143,0,0,6,0,-6
14144,1,0,54,0,-54
14145,1,1,264,1761,1497
14146,0,0,4,0,-4
14147,1,1,742,1304,562
14148,1,0,51,0,-51
14149,1,0,112,0,-112
14150,0,0,2,0,-2
14151,0,0,13,0,-13
14152,1,1,157,1516,1359
14153,0,0,166,0,-166
14154,1,1,141,1259,1118
14155,0,0,26,0,-26
14156,0,0,12,0,-12
14157,0,0,64,0,-64
14158,1,1,1138,1408,270
14159,1,1,323,1291,968
14160,0,0,111,0,-111
14161,1,1,837,1451,614
14162,0,0,160,0,-160
14163,0,0,65,0,-65
14164,1,0,47,0,-47
14165,1,0,41,0,-41
14166,0,0,204,0,-204
14167,0,0,2,0,-2
14168,1,0,12,0,-12
14169,0,0,17,0,-17
14170,1,1,445,1742,1297
14171,1,1,296,1343,1047
14172,0,0,7,0,-7
14173,1,0,25,0,-25
14174,0,0,94,0,-94
14175,1,1,666,1398,732
14176,1,0,71,0,-71
14177,0,0,133,0,-133
14178,0,0,73,0,-73
14179,1,1,2193,1383,-810
14180,1,0,43,0,-43
14181,1,0,179,0,-179
14182,0,0,10,0,-10
14183,0,0,10,0,-10
14184,0,0,131,0,-131
14185,1,0,9,0,-9
14186,1,0,8,0,-8
14187,1,1,179,1423,1244
14188,1,0,84,0,-84
14189,1,1,34,1268,1234
14190,1,1,66,1248,1182
14191,1,0,15,0,-15
14192,0,0,42,0,-42
14193,0,0,65,0,-65
14194,1,0,0,0,0
14195,1,0,39,0,-39
14196,1,0,97,0,-97
14197,1,0,24,0,-24
14198,1,1,2761,1539,-1222
14199,1,1,385,1627,1242
14200,1,1,961,1256,295
14201,0,0,52,0,-52
14202,1,1,1248,1550,302
14203,1,0,98,0,-98
14204,0,0,36,0,-36
14205,0,0,66,0,-66
14206,1,1,961,1342,381
14207,1,1,286,1609,1323
14208,0,0,89,0,-89
14209,0,0,38,0,-38
14210,1,1,400,1536,1136
14211,0,0,2,0,-2
14212,1,1,159,1348,1189
14213,1,1,530,1333,803
14214,1,0,54,0,-54
14215,1,0,86,0,-86
14216,0,0,44,0,-44
14217,1,0,87,0,-87
14218,1,1,1121,1397,276
14219,1,1,1180,1698,518
14220,1,0,40,0,-40
14221,0,0,135,0,-135
14222,0,0,19,0,-19
14223,1,0,158,0,-158
14224,1,1,352,1366,1014
14225,1,0,1,0,-1
14226,1,1,52,1283,1231
14227,0,0,15,0,-15
14228,1,1,522,1580,1058
14229,0,0,18,0,-18
14230,0,0,18,0,-18
14231,1,1,95,1562,1467
14232,0,0,30,0,-30
14233,1,0,281,0,-281
14234,0,0,19,0,-19
14235,0,0,83,0,-83
14236,1,1,207,1693,1486
14237,0,0,14,0,-14
14238,1,0,0,0,0
14239,1,1,1782,1262,-520
14240,0,0,66,0,-66
14241,1,1,586,1337,751
14242,1,0,1,0,-1
14243,1,0,37,0,-37
14244,1,1,128,1542,1414
14245,1,0,36,0,-36
14246,0,0,89,0,-89
14247,1,0,0,0,0
14248,1,0,63,0,-63
14249,0,0,19,0,-19
14250,1,0,34,0,-34
14251,1,1,662,1379,717
14252,0,0,13,0,-13
14253,0,0,10,0,-10
14254,0,0,3,0,-3
14255,0,0,80,0,-80
14256,0,0,12,0,-12
14257,0,0,8,0,-8
14258,0,0,203,0,-203
14259,0,0,17,0,-17
14260,1,1,116,1263,1147
14261,0,0,23,0,-23
14262,1,1,686,1490,804
14263,1,1,416,2423,2007
14264,1,1,106,1721,1615
14265,1,0,73,0,-73
14266,1,0,16,0,-16
14267,1,1,749,1284,535
14268,1,0,16,0,-16
14269,0,0,3,0,-3
14270,1,1,668,1279,611
14271,1,0,47,0,-47
14272,1,0,10,0,-10
14273,1,0,30,0,-30
14274,0,0,29,0,-29
14275,0,0,128,0,-128
14276,0,0,40,0,-40
14277,0,0,3,0,-3
14278,0,0,106,0,-106
14279,1,1,334,2068,1734
14280,1,0,7,0,-7
14281,1,0,136,0,-136
14282,1,0,27,0,-27
14283,0,0,65,0,-65
14284,1,0,81,0,-81
14285,0,0,11,0,-11
14286,1,0,3,0,-3
14287,0,0,35,0,-35
14288,1,1,821,1210,389
14289,1,1,1330,1284,-46
14290,1,1,165,2706,2541
14291,0,0,39,0,-39
14292,0,0,14,0,-14
14293,1,0,27,0,-27
14294,1,0,264,0,-264
14295,0,0,53,0,-53
14296,1,0,44,0,-44
14297,0,0,92,0,-92
14298,0,0,22,0,-22
14299,1,1,269,2360,2091
14300,1,0,58,0,-58
14301,1,1,280,1200,920
14302,0,0,4,0,-4
14303,1,0,84,0,-84
14304,0,0,48,0,-48
14305,0,0,55,0,-55
14306,1,1,194,1476,1282
14307,1,0,39,0,-39
14308,1,0,171,0,-171
14309,1,0,22,0,-22
14310,1,0,440,0,-440
14311,1,0,55,0,-55
14312,1,0,1,0,-1
14313,1,0,48,0,-48
14314,1,1,159,1319,1160
14315,0,0,110,0,-110
14316,0,0,218,0,-218
14317,1,1,597,2252,1655
14318,0,0,7,0,-7
14319,0,0,13,0,-13
14320,0,0,81,0,-81
14321,0,0,10,0,-10
14322,1,0,61,0,-61
14323,1,1,276,1301,1025
14324,1,1,83,1615,1532
14325,1,0,10,0,-10
14326,1,0,123,0,-123
14327,0,0,12,0,-12
14328,1,1,501,1486,985
14329,0,0,64,0,-64
14330,0,0,137,0,-137
14331,1,0,73,0,-73
14332,0,0,26,0,-26
14333,1,0,48,0,-48
14334,1,0,3,0,-3
14335,1,1,541,1238,697
14336,0,0,19,0,-19
14337,0,0,50,0,-50
14338,0,0,74,0,-74
14339,0,0,188,0,-188
14340,0,0,211,0,-211
14341,1,1,471,1578,1107
14342,0,0,71,0,-71
14343,1,0,89,0,-89
14344,0,0,16,0,-16
14345,1,0,7,0,-7
14346,1,1,835,1576,741
14347,1,0,4,0,-4
14348,1,0,199,0,-199
14349,0,0,18,0,-18
14350,1,1,530,1815,1285
14351,1,1,1229,1213,-16
14352,0,0,5,0,-5
14353,1,0,15,0,-15
14354,1,1,309,1510,1201
14355,0,0,24,0,-24
14356,1,1,431,1484,1053
14357,1,0,127,0,-127
14358,1,1,528,2552,2024
14359,1,1,968,1326,358
14360,0,0,44,0,-44
14361,1,1,133,1953,1820
14362,1,0,64,0,-64
14363,1,1,337,1678,1341
14364,0,0,132,0,-132
14365,0,0,7,0,-7
14366,1,1,151,1224,1073
14367,1,0,101,0,-101
14368,1,1,810,1290,480
14369,1,0,10,0,-10
14370,0,0,12,0,-12
14371,0,0,91,0,-91
14372,1,1,275,1218,943
14373,0,0,20,0,-20
14374,1,0,76,0,-76
14375,1,0,11,0,-11
14376,1,0,31,0,-31
14377,0,0,0,0,0
14378,1,1,109,1258,1149
14379,0,0,26,0,-26
14380,0,0,31,0,-31
14381,0,0,0,0,0
14382,0,0,95,0,-95
14383,1,1,1265,1241,-24
14384,1,1,1519,1279,-240
14385,1,0,81,0,-81
14386,1,1,141,1252,1111
14387,1,0,12,0,-12
14388,0,0,15,0,-15
14389,1,0,19,0,-19
14390,0,0,96,0,-96
14391,0,0,10,0,-10
14392,0,0,41,0,-41
14393,0,0,14,0,-14
14394,1,1,293,3163,2870
14395,1,1,459,1741,1282
14396,0,0,49,0,-49
14397,1,0,23,0,-23
14398,1,0,26,0,-26
14399,1,1,954,1574,620
14400,0,0,14,0,-14
14401,1,1,864,1526,662
14402,0,0,73,0,-73
14403,1,0,1,0,-1
14404,1,0,47,0,-47
14405,0,0,20,0,-20
14406,1,0,27,0,-27
14407,1,0,20,0,-20
14408,0,0,116,0,-116
14409,1,1,335,1259,924
14410,1,0,38,0,-38
14411,0,0,101,0,-101
14412,0,0,6,0,-6
14413,1,0,24,0,-24
14414,0,0,7,0,-7
14415,1,1,398,1230,832
14416,0,0,19,0,-19
14417,0,0,3,0,-3
14418,1,1,739,1468,729
14419,0,0,41,0,-41
14420,0,0,93,0,-93
14421,1,0,1,0,-1
14422,0,0,28,0,-28
14423,0,0,30,0,-30
14424,0,0,12,0,-12
14425,1,1,581,1317,736
14426,1,1,147,1672,1525
14427,0,0,4,0,-4
14428,0,0,11,0,-11
14429,1,0,40,0,-40
14430,1,1,122,1243,1121
14431,1,0,230,0,-230
14432,1,1,372,1625,1253
14433,1,0,81,0,-81
14434,0,0,26,0,-26
14435,1,1,51,1964,1913
14436,1,0,116,0,-116
14437,0,0,4,0,-4
14438,0,0,54,0,-54
14439,0,0,21,0,-21
14440,1,1,1044,1244,200
14441,1,1,420,1588,1168
14442,1,0,52,0,-52
14443,0,0,148,0,-148
14444,0,0,5,0,-5
14445,1,0,24,0,-24
14446,1,0,3,0,-3
14447,0,0,31,0,-31
14448,1,0,8,0,-8
14449,1,1,379,1246,867
14450,1,1,90,1258,1168
14451,0,0,44,0,-44
14452,0,0,8,0,-8
14453,0,0,60,0,-60
14454,1,0,123,0,-123
14455,0,0,0,0,0
14456,1,1,188,1730,1542
14457,1,1,167,1426,1259
14458,0,0,36,0,-36
14459,1,1,398,2893,2495
14460,0,0,22,0,-22
14461,1,1,1330,1666,336
14462,1,0,13,0,-13
14463,0,0,19,0,-19
14464,0,0,2,0,-2
14465,0,0,41,0,-41
14466,0,0,7,0,-7
14467,0,0,30,0,-30
14468,1,0,51,0,-51
14469,1,1,197,1517,1320
14470,1,1,1425,1765,340
14471,0,0,59,0,-59
14472,0,0,45,0,-45
14473,1,0,123,0,-123
14474,1,0,78,0,-78
14475,1,1,308,1227,919
14476,1,0,114,0,-114
14477,1,1,1563,1509,-54
14478,1,1,467,1337,870
14479,1,0,69,0,-69
14480,1,0,49,0,-49
14481,1,0,38,0,-38
14482,0,0,47,0,-47
14483,0,0,78,0,-78
14484,1,0,18,0,-18
14485,0,0,87,0,-87
14486,0,0,18,0,-18
14487,0,0,51,0,-51
14488,1,0,3,0,-3
14489,1,1,1799,1433,-366
14490,1,0,12,0,-12
14491,1,0,31,0,-31
14492,1,1,397,1213,816
14493,0,0,19,0,-19
14494,1,1,656,1864,1208
14495,1,0,8,0,-8
14496,0,0,17,0,-17
14497,0,0,178,0,-178
14498,0,0,55,0,-55
14499,1,0,4,0,-4
14500,1,1,1077,1348,271
14501,0,0,54,0,-54
14502,0,0,2,0,-2
14503,0,0,60,0,-60
14504,0,0,110,0,-110
14505,0,0,43,0,-43
14506,0,0,9,0,-9
14507,0,0,62,0,-62
14508,0,0,56,0,-56
14509,1,1,735,1347,612
14510,0,0,9,0,-9
14511,0,0,3,0,-3
14512,1,0,62,0,-62
14513,1,0,33,0,-33
14514,1,0,27,0,-27
14515,1,1,163,1801,1638
14516,1,1,112,1472,1360
14517,1,0,9,0,-9
14518,0,0,26,0,-26
14519,0,0,0,0,0
14520,1,0,64,0,-64
14521,1,0,144,0,-144
14522,0,0,20,0,-20
14523,1,1,806,2211,1405
14524,1,0,148,0,-148
14525,0,0,13,0,-13
14526,0,0,57,0,-57
14527,1,0,33,0,-33
14528,1,0,28,0,-28
14529,1,0,12,0,-12
14530,1,1,533,1482,949
14531,0,0,15,0,-15
14532,1,0,56,0,-56
14533,1,0,99,0,-99
14534,0,0,38,0,-38
14535,0,0,84,0,-84
14536,0,0,30,0,-30
14537,1,0,49,0,-49
14538,1,0,64,0,-64
14539,1,1,1153,1237,84
14540,0,0,12,0,-12
14541,0,0,78,0,-78
14542,1,1,626,1287,661
14543,0,0,61,0,-61
14544,0,0,1,0,-1
14545,1,1,338,2328,1990
14546,1,1,318,1690,1372
14547,1,0,11,0,-11
14548,1,1,197,1220,1023
14549,0,0,10,0,-10
14550,0,0,60,0,-60
14551,0,0,42,0,-42
14552,1,0,140,0,-140
14553,1,0,68,0,-68
14554,1,1,2414,2446,32
14555,1,1,1019,1694,675
14556,0,0,94,0,-94
14557,1,1,38,1593,1555
14558,0,0,53,0,-53
14559,1,1,1030,1479,449
14560,0,0,24,0,-24
14561,1,1,245,1299,1054
14562,0,0,2,0,-2
14563,1,1,491,1514,1023
14564,1,0,75,0,-75
14565,0,0,25,0,-25
14566,1,1,773,1394,621
14567,1,1,281,1270,989
14568,1,0,7,0,-7
14569,1,1,564,1218,654
14570,1,1,315,1283,968
14571,1,1,785,1567,782
14572,1,0,160,0,-160
14573,1,0,102,0,-102
14574,0,0,23,0,-23
14575,1,1,235,1245,1010
14576,0,0,36,0,-36
14577,0,0,29,0,-29
14578,0,0,27,0,-27
14579,0,0,10,0,-10
14580,0,0,80,0,-80
14581,0,0,15,0,-15
14582,1,0,54,0,-54
14583,0,0,50,0,-50
14584,0,0,46,0,-46
14585,1,0,39,0,-39
14586,0,0,10,0,-10
14587,0,0,23,0,-23
14588,1,0,115,0,-115
14589,0,0,48,0,-48
14590,1,1,490,1330,840
14591,0,0,144,0,-144
14592,1,1,405,1599,1194
14593,1,0,21,0,-21
14594,1,1,1077,1322,245
14595,1,0,53,0,-53
14596,1,1,309,1338,1029
14597,1,0,14,0,-14
14598,1,1,477,1459,982
14599,1,1,296,1556,1260
14600,1,1,106,1247,1141
14601,0,0,89,0,-89
14602,1,1,1826,1299,-527
14603,0,0,211,0,-211
14604,0,0,25,0,-25
14605,0,0,161,0,-161
14606,0,0,18,0,-18
14607,0,0,10,0,-10
14608,1,0,165,0,-165
14609,0,0,119,0,-119
14610,0,0,35,0,-35
14611,1,1,1541,1884,343
14612,1,0,12,0,-12
14613,0,0,137,0,-137
14614,1,1,737,1980,1243
14615,0,0,205,0,-205
14616,0,0,2,0,-2
14617,0,0,67,0,-67
14618,1,0,107,0,-107
14619,0,0,3,0,-3
14620,0,0,134,0,-134
14621,0,0,31,0,-31
14622,1,1,404,1661,1257
14623,1,1,1334,3776,2442
14624,0,0,113,0,-113
14625,0,0,84,0,-84
14626,1,1,246,2227,1981
14627,1,1,353,1365,1012
14628,1,0,9,0,-9
14629,0,0,69,0,-69
14630,1,1,690,1900,1210
14631,0,0,52,0,-52
14632,1,1,300,1470,1170
14633,0,0,41,0,-41
14634,1,0,25,0,-25
14635,0,0,97,0,-97
14636,1,1,91,1491,1400
14637,1,1,405,1842,1437
14638,0,0,30,0,-30
14639,1,0,66,0,-66
14640,0,0,61,0,-61
14641,1,1,553,1673,1120
14642,1,1,119,1583,1464
14643,1,1,529,1236,707
14644,0,0,18,0,-18
14645,0,0,128,0,-128
14646,1,1,242,3954,3712
14647,1,1,2047,1778,-269
14648,1,0,79,0,-79
14649,0,0,146,0,-146
14650,1,1,398,1326,928
14651,0,0,75,0,-75
14652,0,0,148,0,-148
14653,0,0,125,0,-125
14654,0,0,55,0,-55
14655,1,0,49,0,-49
14656,1,1,265,2465,2200
14657,1,1,761,1225,464
14658,1,0,103,0,-103
14659,0,0,11,0,-11
14660,1,0,31,0,-31
14661,1,1,210,2030,1820
14662,1,1,46,1751,1705
14663,1,0,27,0,-27
14664,0,0,84,0,-84
14665,0,0,12,0,-12
14666,0,0,1,0,-1
14667,1,0,35,0,-35
14668,1,1,485,1739,1254
14669,0,0,20,0,-20
14670,1,0,34,0,-34
14671,0,0,28,0,-28
14672,1,1,220,1833,1613
14673,0,0,8,0,-8
14674,1,1,706,1253,547
14675,1,1,299,1227,928
14676,1,0,8,0,-8
14677,0,0,45,0,-45
14678,0,0,44,0,-44
14679,0,0,68,0,-68
14680,0,0,1,0,-1
14681,1,0,1,0,-1
14682,1,0,112,0,-112
14683,1,0,15,0,-15
14684,1,1,351,1632,1281
14685,1,0,31,0,-31
14686,1,0,153,0,-153
14687,0,0,46,0,-46
14688,0,0,22,0,-22
14689,1,1,504,1226,722
14690,0,0,12,0,-12
14691,1,1,452,1352,900
14692,0,0,35,0,-35
14693,1,1,2014,5387,3373
14694,0,0,7,0,-7
14695,1,0,166,0,-166
14696,1,0,105,0,-105
14697,0,0,38,0,-38
14698,1,0,36,0,-36
14699,1,0,46,0,-46
14700,1,1,204,1373,1169
14701,1,1,396,1739,1343
14702,1,0,35,0,-35
14703,1,0,92,0,-92
14704,0,0,17,0,-17
14705,1,0,51,0,-51
14706,0,0,81,0,-81
14707,1,0,9,0,-9
14708,1,0,24,0,-24
14709,0,0,46,0,-46
14710,0,0,24,0,-24
14711,1,0,12,0,-12
14712,0,0,12,0,-12
14713,1,0,62,0,-62
14714,0,0,71,0,-71
14715,0,0,63,0,-63
14716,0,0,6,0,-6
14717,0,0,21,0,-21
14718,1,0,0,0,0
14719,0,0,15,0,-15
14720,1,1,74,1213,1139
14721,0,0,66,0,-66
14722,0,0,11,0,-11
14723,1,1,650,2283,1633
14724,0,0,16,0,-16
14725,0,0,29,0,-29
14726,1,0,36,0,-36
14727,1,1,758,1925,1167
14728,0,0,76,0,-76
14729,1,1,642,1317,675
14730,1,1,337,1505,1168
14731,1,0,6,0,-6
14732,1,0,16,0,-16
14733,1,1,670,1428,758
14734,1,1,1146,1464,318
14735,1,0,90,0,-90
14736,1,0,2,0,-2
14737,1,1,142,1406,1264
14738,0,0,111,0,-111
14739,1,0,23,0,-23
14740,0,0,121,0,-121
14741,0,0,91,0,-91
14742,1,0,42,0,-42
14743,0,0,58,0,-58
14744,0,0,107,0,-107
14745,0,0,23,0,-23
14746,1,0,130,0,-130
14747,1,1,682,1252,570
14748,1,0,5,0,-5
14749,1,0,19,0,-19
14750,0,0,2,0,-2
14751,1,1,273,1442,1169
14752,1,0,19,0,-19
14753,0,0,103,0,-103
14754,1,0,75,0,-75
14755,0,0,15,0,-15
14756,1,1,2588,1273,-1315
14757,1,0,23,0,-23
14758,0,0,178,0,-178
14759,1,1,210,1356,1146
14760,0,0,279,0,-279
14761,1,1,145,1715,1570
14762,1,0,41,0,-41
14763,1,1,423,1724,1301
14764,0,0,2,0,-2
14765,1,1,114,1219,1105
14766,1,0,4,0,-4
14767,1,0,11,0,-11
14768,1,0,41,0,-41
14769,1,1,881,2912,2031
14770,1,0,100,0,-100
14771,1,1,630,1245,615
14772,1,1,132,1586,1454
14773,1,0,208,0,-208
14774,0,0,213,0,-213
14775,1,0,38,0,-38
14776,0,0,39,0,-39
14777,1,0,10,0,-10
14778,0,0,22,0,-22
14779,1,0,35,0,-35
14780,1,1,116,1663,1547
14781,1,1,876,1437,561
14782,0,0,44,0,-44
14783,1,0,405,0,-405
14784,1,0,56,0,-56
14785,1,0,28,0,-28
14786,0,0,55,0,-55
14787,1,1,72,1906,1834
14788,1,0,138,0,-138
14789,0,0,13,0,-13
14790,0,0,12,0,-12
14791,0,0,25,0,-25
14792,1,0,39,0,-39
14793,1,1,977,1339,362
14794,1,0,14,0,-14
14795,0,0,38,0,-38
14796,1,0,179,0,-179
14797,1,1,128,2248,2120
14798,1,0,55,0,-55
14799,1,1,397,1681,1284
14800,1,0,17,0,-17
14801,1,0,41,0,-41
14802,0,0,99,0,-99
14803,1,1,1118,1538,420
14804,0,0,3,0,-3
14805,1,1,734,2020,1286
14806,0,0,33,0,-33
14807,1,0,36,0,-36
14808,0,0,5,0,-5
14809,0,0,101,0,-101
14810,1,0,46,0,-46
14811,1,1,186,1422,1236
14812,1,1,274,1646,1372
14813,0,0,46,0,-46
14814,0,0,28,0,-28
14815,1,0,1,0,-1
14816,1,0,113,0,-113
14817,0,0,23,0,-23
14818,1,1,968,1593,625
14819,0,0,31,0,-31
14820,1,0,77,0,-77
14821,0,0,119,0,-119
14822,1,0,30,0,-30
14823,0,0,7,0,-7
14824,1,0,13,0,-13
14825,0,0,120,0,-120
14826,0,0,57,0,-57
14827,0,0,20,0,-20
14828,0,0,2,0,-2
14829,0,0,33,0,-33
14830,0,0,17,0,-17
14831,0,0,89,0,-89
14832,1,1,694,1235,541
14833,1,0,211,0,-211
14834,0,0,37,0,-37
14835,0,0,25,0,-25
14836,0,0,70,0,-70
14837,1,0,107,0,-107
14838,0,0,102,0,-102
14839,1,0,2,0,-2
14840,1,0,21,0,-21
14841,0,0,29,0,-29
14842,0,0,20,0,-20
14843,1,1,71,1333,1262
14844,0,0,126,0,-126
14845,0,0,43,0,-43
14846,1,1,407,2416,2009
14847,0,0,20,0,-20
14848,0,0,53,0,-53
14849,1,1,1103,1302,199
14850,0,0,42,0,-42
14851,0,0,35,0,-35
14852,1,0,5,0,-5
14853,1,1,340,1751,1411
14854,0,0,70,0,-70
14855,1,1,144,1388,1244
14856,1,0,10,0,-10
14857,0,0,70,0,-70
14858,0,0,24,0,-24
14859,1,0,108,0,-108
14860,1,1,308,1413,1105
14861,0,0,34,0,-34
14862,0,0,157,0,-157
14863,1,1,393,1740,1347
14864,1,0,57,0,-57
14865,0,0,144,0,-144
14866,1,0,54,0,-54
14867,1,0,5,0,-5
14868,1,0,49,0,-49
14869,1,0,78,0,-78
14870,1,1,73,1728,1655
14871,1,1,156,1285,1129
14872,0,0,95,0,-95
14873,1,0,17,0,-17
14874,0,0,17,0,-17
14875,1,1,236,1898,1662
14876,1,1,716,1363,647
14877,1,1,467,1448,981
14878,1,0,8,0,-8
14879,1,1,1205,1349,144
14880,1,1,129,1221,1092
14881,1,1,100,1259,1159
14882,0,0,80,0,-80
14883,1,0,33,0,-33
14884,0,0,56,0,-56
14885,1,1,1448,2447,999
14886,1,0,73,0,-73
14887,0,0,46,0,-46
14888,1,0,102,0,-102
14889,0,0,106,0,-106
14890,1,0,39,0,-39
14891,0,0,7,0,-7
14892,1,1,102,1536,1434
14893,0,0,55,0,-55
14894,1,0,80,0,-80
14895,0,0,36,0,-36
14896,0,0,3,0,-3
14897,0,0,137,0,-137
14898,0,0,59,0,-59
14899,1,0,141,0,-141
14900,1,0,18,0,-18
14901,0,0,141,0,-141
14902,1,1,1159,1243,84
14903,0,0,115,0,-115
14904,0,0,33,0,-33
14905,1,1,905,1224,319
14906,1,1,1514,1270,-244
14907,1,0,0,0,0
14908,0,0,17,0,-17
14909,1,0,6,0,-6
14910,1,0,50,0,-50
14911,0,0,15,0,-15
14912,0,0,49,0,-49
14913,1,0,22,0,-22
14914,0,0,43,0,-43
14915,0,0,44,0,-44
14916,1,0,8,0,-8
14917,0,0,130,0,-130
14918,0,0,42,0,-42
14919,1,0,159,0,-159
14920,1,1,743,2073,1330
14921,1,1,994,1426,432
14922,1,1,107,2076,1969
14923,0,0,8,0,-8
14924,1,0,30,0,-30
14925,0,0,118,0,-118
14926,1,1,1208,1799,591
14927,0,0,19,0,-19
14928,1,1,571,1324,753
14929,1,0,2,0,-2
14930,1,0,23,0,-23
14931,0,0,2,0,-2
14932,0,0,14,0,-14
14933,0,0,10,0,-10
14934,1,0,79,0,-79
14935,0,0,80,0,-80
14936,1,1,93,1257,1164
14937,0,0,29,0,-29
14938,1,1,1654,2261,607
14939,1,1,487,1923,1436
14940,1,0,112,0,-112
14941,1,1,311,1322,1011
14942,1,1,225,1229,1004
14943,1,0,29,0,-29
14944,0,0,52,0,-52
14945,0,0,118,0,-118
14946,0,0,114,0,-114
14947,1,1,789,1392,603
14948,0,0,39,0,-39
14949,1,0,47,0,-47
14950,1,1,381,1560,1179
14951,0,0,6,0,-6
14952,0,0,89,0,-89
14953,1,1,322,1261,939
14954,1,0,15,0,-15
14955,0,0,2,0,-2
14956,1,1,911,1426,515
14957,1,1,191,1409,1218
14958,1,1,1176,1777,601
14959,1,1,275,1262,987
14960,1,0,188,0,-188
14961,1,0,14,0,-14
14962,1,1,322,1263,941
14963,1,0,5,0,-5
14964,1,0,24,0,-24
14965,0,0,33,0,-33
14966,1,0,21,0,-21
14967,1,0,34,0,-34
14968,1,1,42,1446,1404
14969,1,0,8,0,-8
14970,1,0,1,0,-1
14971,0,0,50,0,-50
14972,0,0,14,0,-14
14973,0,0,42,0,-42
14974,1,0,62,0,-62
14975,1,1,546,1248,702
14976,0,0,17,0,-17
14977,1,0,86,0,-86
14978,1,0,5,0,-5
14979,1,0,56,0,-56
14980,1,1,853,1531,678
14981,1,1,66,1997,1931
14982,0,0,24,0,-24
14983,1,1,372,1308,936
14984,1,0,99,0,-99
14985,0,0,29,0,-29
14986,1,1,70,1377,1307
14987,0,0,21,0,-21
14988,1,1,217,1460,1243
14989,1,0,22,0,-22
14990,0,0,25,0,-25
14991,1,1,341,2526,2185
14992,1,0,65,0,-65
14993,1,1,292,1751,1459
14994,0,0,29,0,-29
14995,0,0,10,0,-10
14996,1,1,1343,1328,-15
14997,0,0,3,0,-3
14998,0,0,0,0,0
14999,1,1,892,1306,414
15000,1,0,128,0,-128
15001,1,0,23,0,-23
15002,1,0,88,0,-88
15003,1,0,29,0,-29
15004,0,0,92,0,-92
15005,0,0,6,0,-6
15006,1,0,26,0,-26
15007,0,0,36,0,-36
15008,0,0,5,0,-5
15009,0,0,20,0,-20
15010,1,1,108,1857,1749
15011,0,0,53,0,-53
15012,0,0,3,0,-3
15013,0,0,22,0,-22
15014,0,0,27,0,-27
15015,0,0,22,0,-22
15016,1,1,210,1205,995
15017,1,1,666,1876,1210
15018,0,0,23,0,-23
15019,1,1,824,1346,522
15020,1,1,410,1249,839
15021,0,0,54,0,-54
15022,1,0,22,0,-22
15023,0,0,9,0,-9
15024,0,0,67,0,-67
15025,0,0,53,0,-53
15026,0,0,50,0,-50
15027,1,1,985,1837,852
15028,1,1,239,1564,1325
15029,1,1,173,1233,1060
15030,1,1,384,1413,1029
15031,1,0,219,0,-219
15032,0,0,33,0,-33
15033,0,0,35,0,-35
15034,1,0,65,0,-65
15035,1,1,207,1657,1450
15036,1,1,228,1920,1692
15037,0,0,7,0,-7
15038,1,1,409,1874,1465
15039,0,0,162,0,-162
15040,0,0,114,0,-114
15041,0,0,23,0,-23
15042,0,0,54,0,-54
15043,0,0,18,0,-18
15044,1,1,59,1435,1376
15045,1,1,354,2054,1700
15046,1,1,126,1313,1187
15047,1,1,607,1360,753
15048,0,0,41,0,-41
15049,1,1,380,1239,859
15050,0,0,116,0,-116
15051,1,1,863,1358,495
15052,1,1,624,1405,781
15053,0,0,198,0,-198
15054,1,0,30,0,-30
15055,1,0,15,0,-15
15056,1,0,136,0,-136
15057,1,0,44,0,-44
15058,0,0,39,0,-39
15059,1,1,514,1304,790
15060,1,1,978,1641,663
15061,1,0,17,0,-17
15062,1,0,26,0,-26
15063,1,1,176,1964,1788
15064,1,0,23,0,-23
15065,0,0,7,0,-7
15066,0,0,45,0,-45
15067,1,0,11,0,-11
15068,1,0,64,0,-64
15069,0,0,220,0,-220
15070,0,0,10,0,-10
15071,1,1,552,1348,796
15072,1,1,358,2716,2358
15073,1,0,2,0,-2
15074,0,0,12,0,-12
15075,1,0,3,0,-3
15076,0,0,12,0,-12
15077,1,1,148,1375,1227
15078,1,0,9,0,-9
15079,1,1,47,1402,1355
15080,0,0,26,0,-26
15081,1,1,47,1726,1679
15082,1,1,518,1336,818
15083,0,0,17,0,-17
15084,0,0,20,0,-20
15085,1,1,468,1207,739
15086,0,0,63,0,-63
15087,0,0,177,0,-177
15088,0,0,26,0,-26
15089,0,0,5,0,-5
15090,1,1,501,1372,871
15091,1,0,51,0,-51
15092,0,0,17,0,-17
15093,1,1,195,1294,1099
15094,1,1,626,1301,675
15095,0,0,13,0,-13
15096,1,1,1043,1264,221
15097,0,0,31,0,-31
15098,1,0,1,0,-1
15099,1,1,214,1626,1412
15100,1,0,33,0,-33
15101,0,0,44,0,-44
15102,0,0,47,0,-47
15103,1,1,60,2105,2045
15104,1,0,13,0,-13
15105,1,0,5,0,-5
15106,1,1,745,1333,588
15107,1,0,83,0,-83
15108,1,1,120,1219,1099
15109,1,1,441,1503,1062
15110,0,0,11,0,-11
15111,1,0,30,0,-30
15112,0,0,85,0,-85
15113,1,0,16,0,-16
15114,0,0,18,0,-18
15115,1,1,316,1321,1005
15116,0,0,53,0,-53
15117,1,0,69,0,-69
15118,0,0,14,0,-14
15119,1,1,389,1404,1015
15120,0,0,44,0,-44
15121,1,1,1460,1366,-94
15122,0,0,33,0,-33
15123,1,1,758,1442,684
15124,1,0,19,0,-19
15125,1,1,160,1531,1371
15126,1,1,56,1301,1245
15127,1,0,6,0,-6
15128,0,0,10,0,-10
15129,0,0,1,0,-1
15130,0,0,160,0,-160
15131,1,1,402,1459,1057
15132,1,0,82,0,-82
15133,1,0,12,0,-12
15134,1,0,11,0,-11
15135,0,0,44,0,-44
15136,1,0,27,0,-27
15137,0,0,11,0,-11
15138,1,0,1,0,-1
15139,1,0,113,0,-113
15140,0,0,78,0,-78
15141,1,1,1232,2012,780
15142,1,1,260,1308,1048
15143,0,0,196,0,-196
15144,0,0,3,0,-3
15145,0,0,41,0,-41
15146,1,1,520,1246,726
15147,0,0,15,0,-15
15148,0,0,74,0,-74
15149,1,1,348,1708,1360
15150,1,1,1257,1434,177
15151,0,0,25,0,-25
15152,0,0,110,0,-110
15153,1,0,12,0,-12
15154,1,0,5,0,-5
15155,0,0,57,0,-57
15156,0,0,0,0,0
15157,1,0,23,0,-23
15158,0,0,41,0,-41
15159,1,1,528,1437,909
15160,0,0,41,0,-41
15161,1,1,91,2790,2699
15162,0,0,25,0,-25
15163,1,1,356,1422,1066
15164,0,0,6,0,-6
15165,1,0,34,0,-34
15166,0,0,158,0,-158
15167,1,1,735,1618,883
15168,0,0,51,0,-51
15169,1,0,36,0,-36
15170,1,0,74,0,-74
15171,0,0,5,0,-5
15172,1,1,100,1357,1257
15173,1,0,59,0,-59
15174,1,1,388,1408,1020
15175,0,0,15,0,-15
15176,1,0,23,0,-23
15177,1,1,793,2320,1527
15178,0,0,17,0,-17
15179,1,1,1455,1926,471
15180,0,0,33,0,-33
15181,0,0,3,0,-3
15182,0,0,31,0,-31
15183,0,0,68,0,-68
15184,0,0,131,0,-131
15185,1,1,95,2120,2025
15186,1,1,527,1316,789
15187,1,0,22,0,-22
15188,0,0,111,0,-111
15189,1,0,74,0,-74
15190,1,1,439,1719,1280
15191,0,0,22,0,-22
15192,1,1,474,1272,798
15193,0,0,24,0,-24
15194,1,0,3,0,-3
15195,0,0,68,0,-68
15196,1,0,15,0,-15
15197,1,0,8,0,-8
15198,1,0,20,0,-20
15199,0,0,10,0,-10
15200,0,0,132,0,-132
15201,1,1,877,2070,1193
15202,1,1,187,1357,1170
15203,1,0,2,0,-2
15204,1,1,169,1454,1285
15205,0,0,2,0,-2
15206,1,1,260,1483,1223
15207,1,0,119,0,-119
15208,1,1,815,1956,1141
15209,0,0,37,0,-37
15210,1,1,159,1388,1229
15211,0,0,100,0,-100
15212,1,0,80,0,-80
15213,1,1,467,1223,756
15214,1,1,451,1696,1245
15215,0,0,5,0,-5
15216,1,1,281,1312,1031
15217,1,0,20,0,-20
15218,1,0,129,0,-129
15219,0,0,8,0,-8
15220,0,0,2,0,-2
15221,1,1,761,1237,476
15222,1,0,192,0,-192
15223,1,1,138,1414,1276
15224,1,0,30,0,-30
15225,0,0,7,0,-7
15226,1,1,164,1316,1152
15227,1,1,702,1483,781
15228,0,0,62,0,-62
15229,1,1,1156,1311,155
15230,0,0,32,0,-32
15231,1,0,73,0,-73
15232,1,0,7,0,-7
15233,0,0,89,0,-89
15234,1,1,183,3086,2903
15235,1,0,28,0,-28
15236,0,0,49,0,-49
15237,1,1,268,1349,1081
15238,0,0,43,0,-43
15239,1,1,168,1860,1692
15240,0,0,2,0,-2
15241,1,1,575,1233,658
15242,1,0,75,0,-75
15243,0,0,30,0,-30
15244,1,1,409,1838,1429
15245,0,0,46,0,-46
15246,1,0,40,0,-40
15247,1,0,30,0,-30
15248,0,0,49,0,-49
15249,0,0,47,0,-47
15250,1,0,120,0,-120
15251,0,0,5,0,-5
15252,0,0,5,0,-5
15253,0,0,50,0,-50
15254,1,1,427,1220,793
15255,1,0,103,0,-103
15256,0,0,31,0,-31
15257,1,1,206,2037,1831
15258,0,0,29,0,-29
15259,0,0,189,0,-189
15260,1,0,23,0,-23
15261,0,0,27,0,-27
15262,0,0,7,0,-7
15263,1,0,14,0,-14
15264,1,0,22,0,-22
15265,0,0,5,0,-5
15266,1,1,291,1522,1231
15267,1,1,1083,1526,443
15268,1,0,164,0,-164
15269,1,1,337,1414,1077
15270,1,0,65,0,-65
15271,0,0,11,0,-11
15272,0,0,11,0,-11
15273,1,1,352,2730,2378
15274,0,0,48,0,-48
15275,1,1,710,1279,569
15276,1,0,89,0,-89
15277,0,0,80,0,-80
15278,0,0,37,0,-37
15279,0,0,38,0,-38
15280,1,0,22,0,-22
15281,1,1,730,1528,798
15282,1,1,414,1558,1144
15283,0,0,22,0,-22
15284,0,0,169,0,-169
15285,1,1,378,3277,2899
15286,1,1,834,1291,457
15287,1,1,355,1546,1191
15288,0,0,39,0,-39
15289,1,1,1993,1234,-759
15290,1,0,1,0,-1
15291,0,0,43,0,-43
15292,0,0,25,0,-25
15293,1,1,245,1382,1137
15294,1,1,154,1829,1675
15295,1,1,747,1506,759
15296,1,0,36,0,-36
15297,1,1,102,1583,1481
15298,0,0,41,0,-41
15299,0,0,72,0,-72
15300,1,1,392,1200,808
15301,1,0,24,0,-24
15302,1,1,340,1208,868
15303,1,0,43,0,-43
15304,1,1,573,1546,973
15305,1,1,761,1481,720
15306,0,0,121,0,-121
15307,1,1,354,1829,1475
15308,1,0,10,0,-10
15309,0,0,62,0,-62
15310,0,0,64,0,-64
15311,0,0,61,0,-61
15312,0,0,95,0,-95
15313,0,0,26,0,-26
15314,0,0,8,0,-8
15315,0,0,59,0,-59
15316,1,0,83,0,-83
15317,1,1,204,1308,1104
15318,1,1,1465,1318,-147
15319,0,0,28,0,-28
15320,0,0,6,0,-6
15321,0,0,11,0,-11
15322,0,0,18,0,-18
15323,1,0,225,0,-225
15324,0,0,85,0,-85
15325,1,0,83,0,-83
15326,0,0,40,0,-40
15327,0,0,191,0,-191
15328,1,0,58,0,-58
15329,1,0,1,0,-1
15330,1,1,1546,1980,434
15331,1,1,742,1325,583
15332,0,0,116,0,-116
15333,1,1,358,1282,924
15334,0,0,20,0,-20
15335,0,0,52,0,-52
15336,1,0,76,0,-76
15337,1,0,98,0,-98
15338,1,0,51,0,-51
15339,1,0,43,0,-43
15340,1,0,62,0,-62
15341,1,1,80,1406,1326
15342,1,1,251,1616,1365
15343,1,1,456,1281,825
15344,1,1,763,1215,452
15345,1,0,45,0,-45
15346,0,0,11,0,-11
15347,0,0,131,0,-131
15348,1,1,281,1322,1041
15349,0,0,63,0,-63
15350,1,1,1619,1249,-370
15351,1,0,21,0,-21
15352,1,1,918,1463,545
15353,0,0,4,0,-4
15354,0,0,14,0,-14
15355,0,0,50,0,-50
15356,0,0,75,0,-75
15357,1,0,119,0,-119
15358,1,1,2239,1226,-1013
15359,1,0,231,0,-231
15360,0,0,121,0,-121
15361,1,0,71,0,-71
15362,1,1,80,1398,1318
15363,0,0,12,0,-12
15364,0,0,7,0,-7
15365,1,0,1,0,-1
15366,1,0,17,0,-17
15367,0,0,4,0,-4
15368,1,1,276,1213,937
15369,0,0,46,0,-46
15370,1,0,2,0,-2
15371,1,1,790,3023,2233
15372,1,0,52,0,-52
15373,1,0,116,0,-116
15374,1,1,667,1337,670
15375,0,0,19,0,-19
15376,0,0,51,0,-51
15377,0,0,12,0,-12
15378,1,1,144,1356,1212
15379,1,0,87,0,-87
15380,1,0,100,0,-100
15381,1,1,281,1512,1231
15382,1,0,78,0,-78
15383,1,1,360,1917,1557
15384,1,0,23,0,-23
15385,0,0,39,0,-39
15386,1,0,28,0,-28
15387,1,1,359,1393,1034
15388,0,0,26,0,-26
15389,0,0,30,0,-30
15390,0,0,68,0,-68
15391,1,1,149,1223,1074
15392,1,1,925,1371,446
15393,1,0,185,0,-185
15394,1,1,264,1326,1062
15395,0,0,28,0,-28
15396,0,0,54,0,-54
15397,1,0,9,0,-9
15398,1,1,1616,1269,-347
15399,1,0,76,0,-76
15400,0,0,132,0,-132
15401,0,0,52,0,-52
15402,1,0,6,0,-6
15403,1,0,42,0,-42
15404,1,1,1175,1230,55
15405,1,1,148,1208,1060
15406,0,0,70,0,-70
15407,1,0,28,0,-28
15408,1,1,179,1200,1021
15409,1,0,22,0,-22
15410,1,1,394,1625,1231
15411,1,0,52,0,-52
15412,1,1,394,1264,870
15413,1,0,80,0,-80
15414,1,1,459,3888,3429
15415,1,1,160,1339,1179
15416,1,0,71,0,-71
15417,1,1,271,1314,1043
15418,1,0,18,0,-18
15419,0,0,26,0,-26
15420,1,0,102,0,-102
15421,1,0,30,0,-30
15422,1,0,8,0,-8
15423,0,0,48,0,-48
15424,0,0,114,0,-114
15425,1,1,434,1609,1175
15426,0,0,45,0,-45
15427,1,0,30,0,-30
15428,1,1,135,1220,1085
15429,1,0,1,0,-1
15430,0,0,3,0,-3
15431,1,0,10,0,-10
15432,0,0,22,0,-22
15433,0,0,17,0,-17
15434,1,1,345,1647,1302
15435,1,0,5,0,-5
15436,1,1,397,1737,1340
15437,1,0,150,0,-150
15438,0,0,30,0,-30
15439,1,0,169,0,-169
15440,1,0,114,0,-114
15441,0,0,130,0,-130
15442,1,1,1441,1532,91
15443,1,0,24,0,-24
15444,1,1,115,1510,1395
15445,0,0,52,0,-52
15446,1,1,1042,1287,245
15447,1,1,1131,1223,92
15448,1,1,542,1380,838
15449,1,1,666,1409,743
15450,0,0,60,0,-60
15451,0,0,48,0,-48
15452,0,0,25,0,-25
15453,1,1,155,1400,1245
15454,1,0,72,0,-72
15455,0,0,85,0,-85
15456,1,1,114,1610,1496
15457,0,0,37,0,-37
15458,0,0,30,0,-30
15459,0,0,9,0,-9
15460,1,0,29,0,-29
15461,1,1,767,1465,698
15462,0,0,121,0,-121
15463,0,0,19,0,-19
15464,1,1,1129,1733,604
15465,1,1,583,1367,784
15466,1,0,126,0,-126
15467,0,0,20,0,-20
15468,1,0,31,0,-31
15469,1,1,52,1292,1240
15470,0,0,4,0,-4
15471,1,1,140,1227,1087
15472,0,0,44,0,-44
15473,1,1,1417,1223,-194
15474,0,0,2,0,-2
15475,0,0,11,0,-11
15476,0,0,95,0,-95
15477,0,0,44,0,-44
15478,1,0,76,0,-76
15479,1,1,286,2035,1749
15480,1,1,1819,3012,1193
15481,1,0,19,0,-19
15482,0,0,0,0,0
15483,1,0,68,0,-68
15484,0,0,50,0,-50
15485,1,1,1978,1329,-649
15486,1,0,19,0,-19
15487,1,0,1,0,-1
15488,1,0,17,0,-17
15489,0,0,26,0,-26
15490,1,0,105,0,-105
15491,0,0,6,0,-6
15492,0,0,22,0,-22
15493,1,0,26,0,-26
15494,0,0,24,0,-24
15495,0,0,41,0,-41
15496,0,0,90,0,-90
15497,1,1,558,1424,866
15498,1,0,4,0,-4
15499,1,1,1465,1232,-233
15500,1,0,28,0,-28
15501,1,1,728,1954,1226
15502,1,0,14,0,-14
15503,1,1,1600,1241,-359
15504,0,0,87,0,-87
15505,1,0,6,0,-6
15506,1,0,50,0,-50
15507,0,0,8,0,-8
15508,1,1,155,1278,1123
15509,0,0,0,0,0
15510,1,1,322,4031,3709
15511,1,1,394,1245,851
15512,1,1,284,1278,994
15513,0,0,115,0,-115
15514,0,0,35,0,-35
15515,0,0,49,0,-49
15516,1,1,148,1652,1504
15517,0,0,35,0,-35
15518,1,0,26,0,-26
15519,0,0,88,0,-88
15520,1,0,35,0,-35
15521,0,0,76,0,-76
15522,0,0,26,0,-26
15523,1,0,31,0,-31
15524,1,1,159,1316,1157
15525,0,0,1,0,-1
15526,0,0,9,0,-9
15527,0,0,40,0,-40
15528,0,0,59,0,-59
15529,0,0,204,0,-204
15530,1,1,532,1205,673
15531,0,0,1,0,-1
15532,0,0,21,0,-21
15533,1,0,105,0,-105
15534,0,0,14,0,-14
15535,0,0,6,0,-6
15536,1,1,234,1529,1295
15537,1,1,418,1329,911
15538,0,0,49,0,-49
15539,0,0,25,0,-25
15540,1,0,36,0,-36
15541,0,0,5,0,-5
15542,0,0,32,0,-32
15543,0,0,11,0,-11
15544,1,0,2,0,-2
15545,0,0,68,0,-68
15546,0,0,18,0,-18
15547,0,0,19,0,-19
15548,0,0,59,0,-59
15549,0,0,96,0,-96
15550,1,0,7,0,-7
15551,1,1,296,1527,1231
15552,0,0,59,0,-59
15553,1,1,686,1249,563
15554,1,1,40,1209,1169
15555,0,0,61,0,-61
15556,1,0,95,0,-95
15557,1,1,269,1209,940
15558,0,0,42,0,-42
15559,1,0,56,0,-56
15560,1,1,584,1782,1198
15561,1,1,3009,1919,-1090
15562,0,0,18,0,-18
15563,1,0,18,0,-18
15564,0,0,5,0,-5
15565,1,1,125,1372,1247
15566,1,0,159,0,-159
15567,1,0,66,0,-66
15568,0,0,36,0,-36
15569,0,0,35,0,-35
15570,0,0,98,0,-98
15571,0,0,40,0,-40
15572,1,0,21,0,-21
15573,1,1,932,1587,655
15574,1,1,98,1279,1181
15575,1,1,382,1529,1147
15576,1,0,27,0,-27
15577,1,0,53,0,-53
15578,0,0,154,0,-154
15579,0,0,118,0,-118
15580,1,1,631,1200,569
15581,1,0,132,0,-132
15582,0,0,57,0,-57
15583,0,0,50,0,-50
15584,1,1,649,1252,603
15585,1,1,389,1373,984
15586,1,1,168,1447,1279
15587,1,1,589,1534,945
15588,1,0,5,0,-5
15589,1,1,79,1203,1124
15590,0,0,0,0,0
15591,1,0,39,0,-39
15592,1,0,57,0,-57
15593,1,1,166,1292,1126
15594,1,1,60,1752,1692
15595,0,0,30,0,-30
15596,0,0,115,0,-115
15597,1,0,30,0,-30
15598,1,0,96,0,-96
15599,1,1,398,1532,1134
15600,1,0,120,0,-120
15601,0,0,40,0,-40
15602,0,0,141,0,-141
15603,1,0,248,0,-248
15604,1,1,304,1596,1292
15605,0,0,52,0,-52
15606,1,1,1002,1384,382
15607,0,0,12,0,-12
15608,0,0,102,0,-102
15609,0,0,66,0,-66
15610,1,0,80,0,-80
15611,0,0,126,0,-126
15612,0,0,22,0,-22
15613,1,0,21,0,-21
15614,1,0,47,0,-47
15615,1,1,858,1250,392
15616,1,1,388,1217,829
15617,0,0,58,0,-58
15618,1,0,21,0,-21
15619,0,0,2,0,-2
15620,1,1,656,1424,768
15621,1,0,17,0,-17
15622,1,1,783,1318,535
15623,0,0,25,0,-25
15624,0,0,213,0,-213
15625,1,1,357,1236,879
15626,1,0,29,0,-29
15627,1,0,20,0,-20
15628,1,0,21,0,-21
15629,0,0,70,0,-70
15630,0,0,37,0,-37
15631,1,1,656,1353,697
15632,1,0,3,0,-3
15633,1,0,36,0,-36
15634,0,0,64,0,-64
15635,0,0,8,0,-8
15636,0,0,20,0,-20
15637,0,0,45,0,-45
15638,1,1,1633,1694,61
15639,1,0,41,0,-41
15640,0,0,10,0,-10
15641,0,0,80,0,-80
15642,1,1,356,1551,1195
15643,1,1,193,1249,1056
15644,0,0,59,0,-59
15645,1,1,308,1427,1119
15646,0,0,1,0,-1
15647,1,0,4,0,-4
15648,0,0,26,0,-26
15649,0,0,19,0,-19
15650,1,1,308,1498,1190
15651,1,0,60,0,-60
15652,1,0,3,0,-3
15653,0,0,8,0,-8
15654,0,0,59,0,-59
15655,1,1,1376,2142,766
15656,0,0,119,0,-119
15657,0,0,15,0,-15
15658,1,0,40,0,-40
15659,0,0,32,0,-32
15660,1,0,94,0,-94
15661,1,0,25,0,-25
15662,1,1,245,1357,1112
15663,1,0,27,0,-27
15664,1,0,45,0,-45
15665,1,0,95,0,-95
15666,1,1,686,1385,699
15667,1,0,61,0,-61
15668,0,0,54,0,-54
15669,0,0,14,0,-14
15670,1,0,8,0,-8
15671,1,1,261,1776,1515
15672,0,0,192,0,-192
15673,1,0,6,0,-6
15674,1,0,75,0,-75
15675,1,1,328,1236,908
15676,1,1,129,1349,1220
15677,1,1,732,1254,522
15678,1,1,498,1801,1303
15679,1,1,155,1220,1065
15680,1,1,146,3712,3566
15681,1,0,7,0,-7
15682,1,1,377,1588,1211
15683,0,0,1,0,-1
15684,0,0,8,0,-8
15685,1,0,19,0,-19
15686,0,0,9,0,-9
15687,0,0,19,0,-19
15688,0,0,15,0,-15
15689,1,0,35,0,-35
15690,0,0,39,0,-39
15691,1,1,309,1404,1095
15692,1,1,223,1224,1001
15693,1,1,583,1302,719
15694,1,0,32,0,-32
15695,0,0,126,0,-126
15696,1,0,41,0,-41
15697,1,0,16,0,-16
15698,1,0,135,0,-135
15699,1,0,31,0,-31
15700,1,0,34,0,-34
15701,0,0,111,0,-111
15702,1,1,934,1512,578
15703,1,1,286,1202,916
15704,1,0,41,0,-41
15705,1,1,1019,1474,455
15706,1,1,1634,1566,-68
15707,1,0,20,0,-20
15708,1,1,813,1298,485
15709,0,0,69,0,-69
15710,1,0,63,0,-63
15711,1,1,305,3811,3506
15712,0,0,19,0,-19
15713,1,1,81,1229,1148
15714,1,1,155,1260,1105
15715,0,0,35,0,-35
15716,1,1,865,1658,793
15717,1,0,36,0,-36
15718,1,0,27,0,-27
15719,1,0,16,0,-16
15720,1,1,364,2630,2266
15721,1,0,22,0,-22
15722,0,0,12,0,-12
15723,1,1,740,1396,656
15724,0,0,13,0,-13
15725,1,1,944,1508,564
15726,1,0,32,0,-32
15727,1,1,523,1253,730
15728,1,0,25,0,-25
15729,1,1,301,1408,1107
15730,1,1,265,1449,1184
15731,0,0,3,0,-3
15732,0,0,12,0,-12
15733,1,0,198,0,-198
15734,1,0,79,0,-79
15735,1,0,35,0,-35
15736,0,0,46,0,-46
15737,1,1,1246,1430,184
15738,0,0,31,0,-31
15739,0,0,81,0,-81
15740,0,0,3,0,-3
15741,1,0,0,0,0
15742,0,0,4,0,-4
15743,0,0,1,0,-1
15744,0,0,27,0,-27
15745,0,0,67,0,-67
15746,1,0,43,0,-43
15747,0,0,48,0,-48
15748,1,1,178,1221,1043
15749,1,0,37,0,-37
15750,0,0,130,0,-130
15751,1,1,450,1772,1322
15752,0,0,94,0,-94
15753,0,0,42,0,-42
15754,0,0,54,0,-54
15755,0,0,2,0,-2
15756,1,0,101,0,-101
15757,0,0,36,0,-36
15758,0,0,32,0,-32
15759,1,0,105,0,-105
15760,1,1,427,1221,794
15761,0,0,208,0,-208
15762,0,0,126,0,-126
15763,0,0,8,0,-8
15764,0,0,12,0,-12
15765,1,1,345,2848,2503
15766,0,0,20,0,-20
15767,0,0,128,0,-128
15768,0,0,40,0,-40
15769,1,1,180,1633,1453
15770,1,1,141,2472,2331
15771,1,1,57,1953,1896
15772,1,1,217,1558,1341
15773,0,0,2,0,-2
15774,1,0,9,0,-9
15775,1,1,116,1413,1297
15776,1,1,118,1523,1405
15777,1,0,29,0,-29
15778,0,0,12,0,-12
15779,0,0,97,0,-97
15780,0,0,320,0,-320
15781,0,0,0,0,0
15782,1,1,835,1258,423
15783,1,1,620,1799,1179
15784,1,1,336,1352,1016
15785,0,0,90,0,-90
15786,0,0,12,0,-12
15787,0,0,86,0,-86
15788,1,1,2062,1232,-830
15789,1,1,40,1220,1180
15790,1,0,74,0,-74
15791,1,1,1167,1525,358
15792,1,0,47,0,-47
15793,0,0,25,0,-25
15794,0,0,15,0,-15
15795,0,0,91,0,-91
15796,1,1,898,2512,1614
15797,1,0,31,0,-31
15798,1,0,3,0,-3
15799,1,1,70,1653,1583
15800,1,1,968,2059,1091
15801,1,1,1188,1834,646
15802,1,1,633,2339,1706
15803,1,1,359,1259,900
15804,1,1,1859,1712,-147
15805,1,0,17,0,-17
15806,1,0,79,0,-79
15807,1,0,12,0,-12
15808,1,1,162,1337,1175
15809,1,0,30,0,-30
15810,0,0,92,0,-92
15811,0,0,140,0,-140
15812,1,1,970,1364,394
15813,0,0,27,0,-27
15814,1,0,85,0,-85
15815,0,0,43,0,-43
15816,1,0,159,0,-159
15817,1,0,29,0,-29
15818,1,1,2322,1229,-1093
15819,0,0,1,0,-1
15820,0,0,40,0,-40
15821,1,1,362,2237,1875
15822,0,0,72,0,-72
15823,1,1,1040,1228,188
15824,0,0,92,0,-92
15825,1,1,487,1224,737
15826,1,1,310,2513,2203
15827,1,1,212,1491,1279
15828,1,0,19,0,-19
15829,1,1,307,2122,1815
15830,1,0,4,0,-4
15831,1,0,59,0,-59
15832,0,0,10,0,-10
15833,1,0,13,0,-13
15834,1,0,4,0,-4
15835,0,0,53,0,-53
15836,0,0,18,0,-18
15837,0,0,19,0,-19
15838,0,0,40,0,-40
15839,1,1,1178,1703,525
15840,0,0,123,0,-123
15841,1,1,177,1268,1091
15842,1,1,99,1469,1370
15843,1,0,170,0,-170
15844,0,0,91,0,-91
15845,0,0,17,0,-17
15846,1,1,732,1311,579
15847,0,0,1,0,-1
15848,0,0,22,0,-22
15849,1,0,76,0,-76
15850,1,0,83,0,-83
15851,0,0,68,0,-68
15852,1,0,102,0,-102
15853,0,0,24,0,-24
15854,1,0,94,0,-94
15855,0,0,41,0,-41
15856,0,0,13,0,-13
15857,0,0,19,0,-19
15858,0,0,13,0,-13
15859,1,0,48,0,-48
15860,1,1,647,1796,1149
15861,0,0,51,0,-51
15862,1,1,58,1265,1207
15863,1,0,64,0,-64
15864,1,0,57,0,-57
15865,0,0,66,0,-66
15866,1,0,5,0,-5
15867,1,0,30,0,-30
15868,1,0,41,0,-41
15869,1,0,134,0,-134
15870,1,1,1603,1281,-322
15871,1,0,84,0,-84
15872,0,0,15,0,-15
15873,1,0,123,0,-123
15874,1,0,35,0,-35
15875,1,1,205,1305,1100
15876,1,1,428,2083,1655
15877,0,0,71,0,-71
15878,1,0,31,0,-31
15879,0,0,40,0,-40
15880,0,0,37,0,-37
15881,0,0,55,0,-55
15882,0,0,67,0,-67
15883,0,0,18,0,-18
15884,1,0,6,0,-6
15885,1,0,53,0,-53
15886,0,0,55,0,-55
15887,0,0,8,0,-8
15888,0,0,57,0,-57
15889,1,0,89,0,-89
15890,0,0,37,0,-37
15891,1,0,180,0,-180
15892,1,0,2,0,-2
15893,0,0,186,0,-186
15894,1,1,284,2709,2425
15895,1,1,1044,2012,968
15896,1,1,204,1602,1398
15897,1,1,48,1753,1705
15898,1,1,1532,1211,-321
15899,1,0,40,0,-40
15900,1,0,58,0,-58
15901,1,0,55,0,-55
15902,1,1,154,2323,2169
15903,0,0,27,0,-27
15904,1,0,40,0,-40
15905,0,0,121,0,-121
15906,1,1,474,1845,1371
15907,1,0,76,0,-76
15908,0,0,40,0,-40
15909,1,0,76,0,-76
15910,0,0,70,0,-70
15911,1,0,74,0,-74
15912,0,0,28,0,-28
15913,1,0,66,0,-66
15914,1,1,517,1290,773
15915,1,1,441,1207,766
15916,1,0,44,0,-44
15917,1,0,140,0,-140
15918,1,1,418,1255,837
15919,0,0,55,0,-55
15920,1,0,5,0,-5
15921,1,1,1347,2575,1228
15922,1,0,17,0,-17
15923,0,0,19,0,-19
15924,1,0,68,0,-68
15925,1,0,21,0,-21
15926,1,1,327,1298,971
15927,0,0,177,0,-177
15928,0,0,142,0,-142
15929,0,0,7,0,-7
15930,1,1,127,1480,1353
15931,0,0,165,0,-165
15932,1,0,20,0,-20
15933,1,0,15,0,-15
15934,1,0,53,0,-53
15935,1,0,97,0,-97
15936,1,0,166,0,-166
15937,0,0,104,0,-104
15938,1,1,255,1472,1217
15939,1,1,336,1302,966
15940,0,0,2,0,-2
15941,1,1,730,1404,674
15942,1,0,93,0,-93
15943,0,0,3,0,-3
15944,1,1,156,1631,1475
15945,0,0,29,0,-29
15946,0,0,12,0,-12
15947,1,1,763,1299,536
15948,0,0,87,0,-87
15949,1,1,291,1502,1211
15950,0,0,23,0,-23
15951,0,0,1,0,-1
15952,1,0,1,0,-1
15953,1,0,82,0,-82
15954,1,0,5,0,-5
15955,1,1,401,3587,3186
15956,0,0,2,0,-2
15957,0,0,62,0,-62
15958,1,0,10,0,-10
15959,1,0,4,0,-4
15960,1,0,20,0,-20
15961,1,0,224,0,-224
15962,1,1,264,2843,2579
15963,1,1,383,2017,1634
15964,1,0,87,0,-87
15965,0,0,20,0,-20
15966,0,0,7,0,-7
15967,1,1,281,1489,1208
15968,1,0,12,0,-12
15969,0,0,38,0,-38
15970,0,0,6,0,-6
15971,1,0,64,0,-64
15972,0,0,124,0,-124
15973,1,0,30,0,-30
15974,1,0,8,0,-8
15975,0,0,135,0,-135
15976,0,0,138,0,-138
15977,1,1,1065,2777,1712
15978,1,1,169,1789,1620
15979,1,1,565,1231,666
15980,0,0,96,0,-96
15981,1,1,250,1418,1168
15982,0,0,9,0,-9
15983,1,0,90,0,-90
15984,1,0,18,0,-18
15985,1,0,17,0,-17
15986,1,0,16,0,-16
15987,1,0,36,0,-36
15988,1,1,120,1209,1089
15989,1,0,31,0,-31
15990,1,0,66,0,-66
15991,0,0,12,0,-12
15992,0,0,154,0,-154
15993,0,0,36,0,-36
15994,1,1,226,1236,1010
15995,0,0,22,0,-22
15996,1,1,1125,1613,488
15997,0,0,9,0,-9
15998,1,1,384,1428,1044
15999,0,0,46,0,-46
16000,0,0,53,0,-53
16001,1,0,66,0,-66
16002,1,0,53,0,-53
16003,1,0,51,0,-51
16004,1,0,71,0,-71
16005,1,0,66,0,-66
16006,1,1,1613,1253,-360
16007,1,1,332,1635,1303
16008,0,0,66,0,-66
16009,1,0,6,0,-6
16010,0,0,15,0,-15
16011,1,0,199,0,-199
16012,0,0,23,0,-23
16013,1,1,1142,1316,174
16014,0,0,1,0,-1
16015,1,0,17,0,-17
16016,0,0,52,0,-52
16017,0,0,11,0,-11
16018,1,0,2,0,-2
16019,0,0,24,0,-24
16020,1,1,535,1395,860
16021,1,0,112,0,-112
16022,1,0,36,0,-36
16023,1,0,1,0,-1
16024,1,0,128,0,-128
16025,1,1,597,1457,860
16026,1,0,8,0,-8
16027,1,0,79,0,-79
16028,1,0,147,0,-147
16029,1,0,12,0,-12
16030,0,0,95,0,-95
16031,1,1,596,1467,871
16032,1,0,34,0,-34
16033,1,0,10,0,-10
16034,0,0,17,0,-17
16035,0,0,9,0,-9
16036,0,0,7,0,-7
16037,0,0,140,0,-140
16038,1,0,8,0,-8
16039,1,0,12,0,-12
16040,0,0,46,0,-46
16041,0,0,14,0,-14
16042,0,0,59,0,-59
16043,1,0,28,0,-28
16044,1,1,384,1304,920
16045,1,0,9,0,-9
16046,1,0,37,0,-37
16047,1,0,16,0,-16
16048,1,1,121,1483,1362
16049,0,0,23,0,-23
16050,1,1,1433,1679,246
16051,0,0,121,0,-121
16052,0,0,21,0,-21
16053,1,1,166,1271,1105
16054,1,1,1224,1404,180
16055,1,1,717,1204,487
16056,1,0,2,0,-2
16057,1,0,7,0,-7
16058,1,0,5,0,-5
16059,1,0,21,0,-21
16060,0,0,25,0,-25
16061,1,0,53,0,-53
16062,0,0,23,0,-23
16063,1,0,53,0,-53
16064,1,0,12,0,-12
16065,1,1,208,1718,1510
16066,0,0,116,0,-116
16067,1,0,124,0,-124
16068,1,0,55,0,-55
16069,1,0,25,0,-25
16070,1,1,410,1523,1113
16071,1,1,503,1477,974
16072,0,0,16,0,-16
16073,1,0,80,0,-80
16074,1,0,56,0,-56
16075,1,0,3,0,-3
16076,0,0,19,0,-19
16077,0,0,0,0,0
16078,1,1,246,1222,976
16079,0,0,99,0,-99
16080,1,1,1368,2659,1291
16081,0,0,86,0,-86
16082,0,0,11,0,-11
16083,1,0,91,0,-91
16084,1,0,16,0,-16
16085,0,0,53,0,-53
16086,1,1,135,1303,1168
16087,1,1,320,1551,1231
16088,0,0,12,0,-12
16089,1,1,307,1291,984
16090,1,0,50,0,-50
16091,1,1,938,1478,540
16092,0,0,94,0,-94
16093,0,0,18,0,-18
16094,0,0,62,0,-62
16095,1,1,523,1620,1097
16096,0,0,23,0,-23
16097,1,0,24,0,-24
16098,1,0,17,0,-17
16099,1,0,38,0,-38
16100,1,0,17,0,-17
16101,0,0,172,0,-172
16102,1,0,5,0,-5
16103,1,0,21,0,-21
16104,1,0,9,0,-9
16105,1,1,543,1243,700
16106,1,1,285,1589,1304
16107,1,0,39,0,-39
16108,1,1,372,1395,1023
16109,1,0,5,0,-5
16110,1,0,50,0,-50
16111,1,1,890,1668,778
16112,0,0,48,0,-48
16113,0,0,37,0,-37
16114,1,0,88,0,-88
16115,0,0,21,0,-21
16116,1,1,584,1592,1008
16117,0,0,72,0,-72
16118,1,0,10,0,-10
16119,1,1,600,1276,676
16120,0,0,32,0,-32
16121,1,1,311,1289,978
16122,1,0,77,0,-77
16123,1,0,28,0,-28
16124,1,0,37,0,-37
16125,1,0,36,0,-36
16126,1,0,139,0,-139
16127,1,0,0,0,0
16128,1,1,404,2195,1791
16129,0,0,108,0,-108
16130,0,0,17,0,-17
16131,1,0,7,0,-7
16132,1,1,773,1315,542
16133,0,0,128,0,-128
16134,1,1,547,1429,882
16135,0,0,7,0,-7
16136,0,0,17,0,-17
16137,1,1,623,2337,1714
16138,0,0,43,0,-43
16139,1,0,107,0,-107
16140,1,1,469,1999,1530
16141,1,0,39,0,-39
16142,1,1,1404,1866,462
16143,0,0,19,0,-19
16144,0,0,23,0,-23
16145,1,1,95,1355,1260
16146,0,0,86,0,-86
16147,0,0,85,0,-85
16148,1,1,1219,1316,97
16149,1,0,5,0,-5
16150,0,0,65,0,-65
16151,1,0,31,0,-31
16152,1,0,24,0,-24
16153,0,0,5,0,-5
16154,1,0,3,0,-3
16155,1,0,27,0,-27
16156,1,0,22,0,-22
16157,0,0,91,0,-91
16158,1,1,779,1809,1030
16159,1,0,10,0,-10
16160,1,1,265,1350,1085
16161,1,0,36,0,-36
16162,1,0,23,0,-23
16163,1,1,227,2743,2516
16164,1,1,1028,1600,572
16165,1,1,703,1940,1237
16166,1,0,46,0,-46
16167,0,0,133,0,-133
16168,0,0,77,0,-77
16169,1,0,11,0,-11
16170,1,1,1170,1337,167
16171,1,1,518,2122,1604
16172,0,0,20,0,-20
16173,0,0,82,0,-82
16174,1,1,107,1202,1095
16175,1,0,5,0,-5
16176,1,0,71,0,-71
16177,1,1,966,2092,1126
16178,1,1,220,1387,1167
16179,0,0,99,0,-99
16180,1,0,22,0,-22
16181,0,0,2,0,-2
16182,0,0,173,0,-173
16183,1,1,761,1399,638
16184,1,1,944,1249,305
16185,0,0,1,0,-1
16186,1,1,26,1900,1874
16187,0,0,7,0,-7
16188,1,0,70,0,-70
16189,0,0,67,0,-67
16190,1,0,90,0,-90
16191,1,1,119,1557,1438
16192,0,0,58,0,-58
16193,1,1,127,1376,1249
16194,1,1,376,1244,868
16195,1,0,23,0,-23
16196,0,0,2,0,-2
16197,1,1,121,1592,1471
16198,1,0,4,0,-4
16199,0,0,83,0,-83
16200,0,0,14,0,-14
16201,1,0,173,0,-173
16202,0,0,15,0,-15
16203,0,0,25,0,-25
16204,1,1,194,1272,1078
16205,1,1,257,1308,1051
16206,0,0,23,0,-23
16207,0,0,38,0,-38
16208,1,1,209,1425,1216
16209,0,0,44,0,-44
16210,1,1,145,3002,2857
16211,1,0,47,0,-47
16212,1,1,946,1229,283
16213,1,1,1418,1289,-129
16214,0,0,88,0,-88
16215,1,1,441,1223,782
16216,1,0,79,0,-79
16217,1,0,7,0,-7
16218,0,0,2,0,-2
16219,1,0,22,0,-22
16220,0,0,70,0,-70
16221,0,0,65,0,-65
16222,0,0,56,0,-56
16223,0,0,34,0,-34
16224,0,0,11,0,-11
16225,1,1,92,1206,1114
16226,1,0,58,0,-58
16227,0,0,11,0,-11
16228,1,0,0,0,0
16229,0,0,11,0,-11
16230,0,0,21,0,-21
16231,1,0,27,0,-27
16232,1,0,78,0,-78
16233,0,0,22,0,-22
16234,0,0,80,0,-80
16235,0,0,44,0,-44
16236,0,0,81,0,-81
16237,0,0,6,0,-6
16238,1,0,144,0,-144
16239,0,0,149,0,-149
16240,1,0,65,0,-65
16241,1,1,376,1316,940
16242,0,0,105,0,-105
16243,0,0,7,0,-7
16244,1,1,650,1930,1280
16245,1,0,1,0,-1
16246,1,1,645,1223,578
16247,0,0,1,0,-1
16248,1,1,648,1255,607
16249,1,1,981,1520,539
16250,0,0,0,0,0
16251,0,0,54,0,-54
16252,1,1,225,1669,1444
16253,1,1,64,1799,1735
16254,1,1,1085,1264,179
16255,1,1,70,1705,1635
16256,1,0,16,0,-16
16257,1,1,48,1211,1163
16258,1,1,112,1520,1408
16259,0,0,45,0,-45
16260,0,0,74,0,-74
16261,1,1,232,1277,1045
16262,0,0,118,0,-118
16263,0,0,174,0,-174
16264,1,0,50,0,-50
16265,1,1,207,1254,1047
16266,0,0,57,0,-57
16267,1,0,2,0,-2
16268,0,0,0,0,0
16269,0,0,36,0,-36
16270,0,0,35,0,-35
16271,1,0,35,0,-35
16272,0,0,39,0,-39
16273,1,0,230,0,-230
16274,1,0,65,0,-65
16275,0,0,7,0,-7
16276,0,0,11,0,-11
16277,0,0,0,0,0
16278,1,1,673,1393,720
16279,0,0,157,0,-157
16280,1,0,0,0,0
16281,1,1,84,2133,2049
16282,0,0,38,0,-38
16283,0,0,38,0,-38
16284,1,1,482,1327,845
16285,1,1,9,2100,2091
16286,1,1,937,1978,1041
16287,1,0,36,0,-36
16288,1,0,123,0,-123
16289,0,0,95,0,-95
16290,1,1,423,2066,1643
16291,1,1,195,1696,1501
16292,0,0,43,0,-43
16293,0,0,4,0,-4
16294,0,0,139,0,-139
16295,0,0,29,0,-29
16296,0,0,34,0,-34
16297,1,1,310,1635,1325
16298,1,1,935,1378,443
16299,0,0,112,0,-112
16300,1,0,25,0,-25
16301,0,0,59,0,-59
16302,0,0,44,0,-44
16303,0,0,27,0,-27
16304,1,0,94,0,-94
16305,1,0,30,0,-30
16306,1,1,179,1204,1025
16307,0,0,290,0,-290
16308,1,0,7,0,-7
16309,1,0,47,0,-47
16310,1,1,308,1356,1048
16311,0,0,15,0,-15
16312,0,0,19,0,-19
16313,0,0,103,0,-103
16314,1,0,1,0,-1
16315,1,0,18,0,-18
16316,0,0,28,0,-28
16317,1,0,85,0,-85
16318,1,0,81,0,-81
16319,0,0,20,0,-20
16320,1,1,191,1311,1120
16321,1,1,1187,1280,93
16322,0,0,1,0,-1
16323,1,1,482,1267,785
16324,1,0,13,0,-13
16325,1,0,26,0,-26
16326,1,1,157,1426,1269
16327,0,0,66,0,-66
16328,1,1,935,1280,345
16329,1,1,1476,1573,97
16330,0,0,7,0,-7
16331,1,0,14,0,-14
16332,1,0,23,0,-23
16333,0,0,75,0,-75
16334,0,0,75,0,-75
16335,1,0,21,0,-21
16336,1,1,1520,1275,-245
16337,1,1,673,1215,542
16338,1,1,186,2217,2031
16339,1,0,50,0,-50
16340,1,0,79,0,-79
16341,0,0,22,0,-22
16342,0,0,25,0,-25
16343,0,0,31,0,-31
16344,1,1,449,1238,789
16345,1,0,19,0,-19
16346,1,0,16,0,-16
16347,1,1,619,1427,808
16348,1,0,49,0,-49
16349,1,1,101,1472,1371
16350,1,1,100,1406,1306
16351,0,0,95,0,-95
16352,1,0,108,0,-108
16353,1,0,34,0,-34
16354,0,0,67,0,-67
16355,1,0,32,0,-32
16356,1,0,47,0,-47
16357,1,0,83,0,-83
16358,0,0,19,0,-19
16359,1,1,86,1470,1384
16360,1,1,331,1234,903
16361,1,1,580,1365,785
16362,1,0,43,0,-43
16363,0,0,13,0,-13
16364,1,0,19,0,-19
16365,0,0,45,0,-45
16366,0,0,17,0,-17
16367,0,0,27,0,-27
16368,0,0,2,0,-2
16369,1,0,73,0,-73
16370,1,1,438,1242,804
16371,1,0,17,0,-17
16372,1,0,50,0,-50
16373,1,1,17,1254,1237
16374,0,0,3,0,-3
16375,1,0,58,0,-58
16376,1,1,1943,1796,-147
16377,1,0,0,0,0
16378,1,0,107,0,-107
16379,1,0,64,0,-64
16380,1,1,99,1407,1308
16381,0,0,146,0,-146
16382,1,1,237,1234,997
16383,0,0,20,0,-20
16384,0,0,49,0,-49
16385,1,0,59,0,-59
16386,0,0,8,0,-8
16387,0,0,8,0,-8
16388,0,0,0,0,0
16389,1,0,32,0,-32
16390,0,0,17,0,-17
16391,1,1,516,1412,896
16392,0,0,66,0,-66
16393,1,0,15,0,-15
16394,0,0,2,0,-2
16395,1,1,934,2135,1201
16396,1,0,30,0,-30
16397,1,0,26,0,-26
16398,1,1,378,1254,876
16399,0,0,50,0,-50
16400,1,0,34,0,-34
16401,0,0,3,0,-3
16402,0,0,6,0,-6
16403,1,1,523,1400,877
16404,0,0,19,0,-19
16405,1,1,587,1409,822
16406,1,1,334,1218,884
16407,1,1,402,2910,2508
16408,0,0,25,0,-25
16409,1,1,526,1320,794
16410,0,0,32,0,-32
16411,1,0,4,0,-4
16412,0,0,9,0,-9
16413,1,0,11,0,-11
16414,0,0,42,0,-42
16415,0,0,54,0,-54
16416,1,0,84,0,-84
16417,0,0,57,0,-57
16418,0,0,11,0,-11
16419,0,0,36,0,-36
16420,0,0,47,0,-47
16421,0,0,3,0,-3
16422,1,0,5,0,-5
16423,1,1,907,1325,418
16424,1,1,234,2050,1816
16425,1,1,404,1647,1243
16426,1,0,4,0,-4
16427,0,0,7,0,-7
16428,0,0,86,0,-86
16429,0,0,46,0,-46
16430,0,0,108,0,-108
16431,0,0,24,0,-24
16432,1,0,82,0,-82
16433,1,1,783,1373,590
16434,0,0,28,0,-28
16435,0,0,0,0,0
16436,0,0,18,0,-18
16437,0,0,5,0,-5
16438,1,1,147,1687,1540
16439,1,1,237,1339,1102
16440,1,0,39,0,-39
16441,0,0,41,0,-41
16442,1,0,206,0,-206
16443,1,1,145,1270,1125
16444,0,0,7,0,-7
16445,1,0,9,0,-9
16446,1,0,29,0,-29
16447,0,0,0,0,0
16448,1,1,152,1316,1164
16449,1,1,301,1310,1009
16450,1,0,14,0,-14
16451,1,1,183,1398,1215
16452,1,1,122,2150,2028
16453,0,0,59,0,-59
16454,0,0,79,0,-79
16455,1,1,1372,1578,206
16456,1,1,18,1762,1744
16457,1,1,371,1259,888
16458,0,0,5,0,-5
16459,0,0,132,0,-132
16460,1,0,33,0,-33
16461,1,1,661,1331,670
16462,0,0,22,0,-22
16463,1,0,21,0,-21
16464,0,0,3,0,-3
16465,1,0,37,0,-37
16466,1,0,1,0,-1
16467,1,1,180,1342,1162
16468,0,0,54,0,-54
16469,1,1,213,1423,1210
16470,0,0,26,0,-26
16471,0,0,49,0,-49
16472,1,0,68,0,-68
16473,0,0,17,0,-17
16474,1,1,77,1904,1827
16475,1,0,20,0,-20
16476,0,0,25,0,-25
16477,0,0,160,0,-160
16478,1,0,27,0,-27
16479,1,0,58,0,-58
16480,0,0,64,0,-64
16481,1,1,101,2086,1985
16482,0,0,51,0,-51
16483,1,1,383,1811,1428
16484,1,0,40,0,-40
16485,0,0,48,0,-48
16486,0,0,4,0,-4
16487,0,0,6,0,-6
16488,1,0,91,0,-91
16489,1,0,5,0,-5
16490,1,1,161,1236,1075
16491,1,0,37,0,-37
16492,1,0,8,0,-8
16493,1,1,773,1464,691
16494,1,1,115,1456,1341
16495,1,1,888,2215,1327
16496,0,0,0,0,0
16497,0,0,9,0,-9
16498,1,0,3,0,-3
16499,1,0,19,0,-19
16500,0,0,10,0,-10
16501,1,0,16,0,-16
16502,0,0,66,0,-66
16503,0,0,13,0,-13
16504,1,0,265,0,-265
16505,0,0,42,0,-42
16506,1,0,74,0,-74
16507,0,0,4,0,-4
16508,0,0,0,0,0
16509,0,0,51,0,-51
16510,1,1,1168,1427,259
16511,1,0,60,0,-60
16512,0,0,5,0,-5
16513,1,0,7,0,-7
16514,0,0,18,0,-18
16515,1,1,254,1792,1538
16516,1,1,46,1258,1212
16517,1,1,375,1656,1281
16518,1,0,116,0,-116
16519,0,0,0,0,0
16520,1,0,84,0,-84
16521,0,0,12,0,-12
16522,1,1,692,1470,778
16523,1,1,444,1229,785
16524,0,0,83,0,-83
16525,0,0,77,0,-77
16526,1,0,88,0,-88
16527,1,0,0,0,0
16528,0,0,24,0,-24
16529,1,0,15,0,-15
16530,0,0,140,0,-140
16531,0,0,45,0,-45
16532,1,0,3,0,-3
16533,1,0,86,0,-86
16534,1,0,55,0,-55
16535,1,1,62,2689,2627
16536,1,1,579,1558,979
16537,1,1,526,1845,1319
16538,0,0,53,0,-53
16539,1,1,637,1212,575
16540,1,1,82,1224,1142
16541,0,0,35,0,-35
16542,1,1,977,1253,276
16543,1,1,406,1385,979
16544,1,0,23,0,-23
16545,1,0,8,0,-8
16546,0,0,34,0,-34
16547,1,1,236,1573,1337
16548,1,1,1319,1251,-68
16549,1,1,535,1512,977
16550,1,0,68,0,-68
16551,1,0,189,0,-189
16552,1,1,171,1354,1183
16553,0,0,33,0,-33
16554,0,0,23,0,-23
16555,1,0,11,0,-11
16556,1,1,313,1213,900
16557,0,0,23,0,-23
16558,1,1,769,1359,590
16559,1,1,594,1850,1256
16560,0,0,38,0,-38
16561,1,0,3,0,-3
16562,0,0,41,0,-41
16563,1,0,3,0,-3
16564,0,0,234,0,-234
16565,1,1,190,1512,1322
16566,0,0,49,0,-49
16567,0,0,0,0,0
16568,1,1,1458,1206,-252
16569,0,0,17,0,-17
16570,1,1,664,1291,627
16571,0,0,14,0,-14
16572,1,1,87,1356,1269
16573,0,0,123,0,-123
16574,1,1,377,1711,1334
16575,1,1,555,1224,669
16576,0,0,16,0,-16
16577,0,0,104,0,-104
16578,0,0,36,0,-36
16579,0,0,1,0,-1
16580,0,0,54,0,-54
16581,1,1,385,1270,885
16582,1,0,14,0,-14
16583,1,1,484,2546,2062
16584,1,1,1063,2356,1293
16585,0,0,65,0,-65
16586,1,0,16,0,-16
16587,1,1,357,1227,870
16588,0,0,42,0,-42
16589,0,0,20,0,-20
16590,1,1,160,1413,1253
16591,1,1,691,1225,534
16592,1,0,46,0,-46
16593,1,0,6,0,-6
16594,1,1,1022,1413,391
16595,1,0,65,0,-65
16596,0,0,7,0,-7
16597,1,1,750,1377,627
16598,1,0,87,0,-87
16599,0,0,46,0,-46
16600,1,1,150,1387,1237
16601,0,0,65,0,-65
16602,0,0,29,0,-29
16603,1,0,51,0,-51
16604,0,0,77,0,-77
16605,0,0,30,0,-30
16606,0,0,2,0,-2
16607,1,1,132,1248,1116
16608,1,0,101,0,-101
16609,0,0,42,0,-42
16610,0,0,94,0,-94
16611,1,0,20,0,-20
16612,1,1,632,1507,875
16613,1,1,368,1204,836
16614,1,1,548,2216,1668
16615,1,1,1033,1799,766
16616,1,1,317,1600,1283
16617,0,0,86,0,-86
16618,0,0,55,0,-55
16619,0,0,23,0,-23
16620,1,0,5,0,-5
16621,1,1,344,1260,916
16622,0,0,20,0,-20
16623,1,1,970,1456,486
16624,1,1,230,1287,1057
16625,1,0,141,0,-141
16626,1,1,110,2465,2355
16627,1,0,33,0,-33
16628,1,1,379,1548,1169
16629,1,1,2135,1510,-625
16630,1,1,714,1243,529
16631,0,0,55,0,-55
16632,1,0,48,0,-48
16633,0,0,3,0,-3
16634,0,0,66,0,-66
16635,0,0,11,0,-11
16636,1,0,25,0,-25
16637,1,1,1327,1779,452
16638,1,1,140,4244,4104
16639,1,0,7,0,-7
16640,1,1,479,1947,1468
16641,1,1,591,1305,714
16642,1,0,7,0,-7
16643,1,0,56,0,-56
16644,0,0,161,0,-161
16645,0,0,33,0,-33
16646,1,1,267,1220,953
16647,1,1,731,2031,1300
16648,1,1,184,1966,1782
16649,1,0,100,0,-100
16650,1,0,90,0,-90
16651,0,0,48,0,-48
16652,1,0,74,0,-74
16653,1,1,543,1216,673
16654,1,0,22,0,-22
16655,1,1,124,2069,1945
16656,1,0,66,0,-66
16657,1,0,17,0,-17
16658,0,0,1,0,-1
16659,0,0,85,0,-85
16660,1,0,196,0,-196
16661,1,1,240,1984,1744
16662,1,1,471,1479,1008
16663,1,1,339,1857,1518
16664,1,1,990,1244,254
16665,1,1,307,1230,923
16666,1,0,44,0,-44
16667,1,0,97,0,-97
16668,0,0,12,0,-12
16669,1,0,102,0,-102
16670,1,0,54,0,-54
16671,1,0,39,0,-39
16672,1,0,208,0,-208
16673,1,1,355,1273,918
16674,0,0,44,0,-44
16675,1,1,1597,1313,-284
16676,0,0,84,0,-84
16677,1,1,63,1276,1213
16678,1,1,199,2080,1881
16679,1,1,717,1774,1057
16680,1,1,303,1340,1037
16681,0,0,104,0,-104
16682,1,0,8,0,-8
16683,0,0,76,0,-76
16684,0,0,14,0,-14
16685,1,0,32,0,-32
16686,1,0,25,0,-25
16687,0,0,4,0,-4
16688,1,0,134,0,-134
16689,0,0,51,0,-51
16690,1,0,24,0,-24
16691,0,0,5,0,-5
16692,0,0,7,0,-7
16693,0,0,2,0,-2
16694,1,0,49,0,-49
16695,0,0,43,0,-43
16696,1,1,1854,1391,-463
16697,0,0,70,0,-70
16698,1,0,27,0,-27
16699,1,1,404,1287,883
16700,1,0,83,0,-83
16701,0,0,76,0,-76
16702,1,1,183,1286,1103
16703,0,0,153,0,-153
16704,1,0,51,0,-51
16705,1,1,854,1441,587
16706,1,0,34,0,-34
16707,1,0,66,0,-66
16708,0,0,147,0,-147
16709,0,0,110,0,-110
16710,0,0,18,0,-18
16711,1,1,204,1378,1174
16712,0,0,12,0,-12
16713,1,1,720,1443,723
16714,1,0,7,0,-7
16715,1,1,244,1258,1014
16716,1,1,819,1291,472
16717,1,1,394,1305,911
16718,0,0,53,0,-53
16719,1,1,185,1219,1034
16720,1,1,241,1732,1491
16721,0,0,19,0,-19
16722,1,1,63,1281,1218
16723,0,0,145,0,-145
16724,1,1,718,1834,1116
16725,1,0,16,0,-16
16726,1,0,0,0,0
16727,1,1,517,1793,1276
16728,1,1,421,1683,1262
16729,0,0,8,0,-8
16730,0,0,38,0,-38
16731,0,0,60,0,-60
16732,1,0,101,0,-101
16733,1,0,50,0,-50
16734,1,0,81,0,-81
16735,1,1,33,1246,1213
16736,1,0,246,0,-246
16737,1,1,948,1715,767
16738,0,0,18,0,-18
16739,1,0,15,0,-15
16740,1,1,60,1416,1356
16741,1,0,55,0,-55
16742,0,0,70,0,-70
16743,1,1,382,1298,916
16744,1,1,310,1319,1009
16745,1,1,1191,2628,1437
16746,0,0,10,0,-10
16747,1,1,192,1608,1416
16748,0,0,4,0,-4
16749,0,0,24,0,-24
16750,0,0,43,0,-43
16751,1,1,618,1424,806
16752,1,1,41,1990,1949
16753,1,0,104,0,-104
16754,0,0,62,0,-62
16755,1,1,884,1368,484
16756,1,0,32,0,-32
16757,1,1,132,1293,1161
16758,1,1,523,1588,1065
16759,1,1,576,1454,878
16760,1,0,72,0,-72
16761,1,1,319,1667,1348
16762,0,0,0,0,0
16763,1,0,100,0,-100
16764,0,0,127,0,-127
16765,0,0,56,0,-56
16766,1,1,87,2091,2004
16767,1,0,60,0,-60
16768,1,1,31,1306,1275
16769,1,0,46,0,-46
16770,1,0,63,0,-63
16771,1,0,26,0,-26
16772,0,0,37,0,-37
16773,0,0,77,0,-77
16774,1,1,269,2143,1874
16775,1,1,71,1693,1622
16776,1,0,9,0,-9
16777,1,0,67,0,-67
16778,1,1,323,1926,1603
16779,1,0,15,0,-15
16780,0,0,74,0,-74
16781,0,0,72,0,-72
16782,1,0,58,0,-58
16783,1,1,288,1404,1116
16784,1,0,23,0,-23
16785,0,0,97,0,-97
16786,1,0,61,0,-61
16787,1,1,211,1217,1006
16788,1,0,0,0,0
16789,1,1,93,1212,1119
16790,1,1,147,1569,1422
16791,0,0,46,0,-46
16792,1,0,12,0,-12
16793,1,0,118,0,-118
16794,1,0,17,0,-17
16795,0,0,43,0,-43
16796,0,0,52,0,-52
16797,1,1,1024,1443,419
16798,1,1,579,1608,1029
16799,1,0,3,0,-3
16800,1,1,858,1525,667
16801,1,1,427,1352,925
16802,1,1,968,1405,437
16803,0,0,48,0,-48
16804,0,0,11,0,-11
16805,1,1,1084,1358,274
16806,0,0,203,0,-203
16807,0,0,2,0,-2
16808,0,0,85,0,-85
16809,1,0,39,0,-39
16810,0,0,134,0,-134
16811,1,0,59,0,-59
16812,1,0,42,0,-42
16813,1,0,96,0,-96
16814,1,0,12,0,-12
16815,0,0,163,0,-163
16816,0,0,82,0,-82
16817,1,1,217,1611,1394
16818,1,1,138,1306,1168
16819,1,0,60,0,-60
16820,1,0,37,0,-37
16821,1,1,611,2351,1740
16822,0,0,2,0,-2
16823,0,0,93,0,-93
16824,1,0,1,0,-1
16825,0,0,28,0,-28
16826,0,0,59,0,-59
16827,1,1,169,1508,1339
16828,0,0,31,0,-31
16829,0,0,7,0,-7
16830,1,0,32,0,-32
16831,1,0,22,0,-22
16832,0,0,150,0,-150
16833,1,0,27,0,-27
16834,0,0,156,0,-156
16835,1,1,955,2423,1468
16836,1,0,38,0,-38
16837,1,0,33,0,-33
16838,1,1,564,1518,954
16839,1,1,135,1307,1172
16840,1,1,320,1428,1108
16841,0,0,131,0,-131
16842,1,0,8,0,-8
16843,0,0,159,0,-159
16844,0,0,59,0,-59
16845,0,0,22,0,-22
16846,1,0,1,0,-1
16847,0,0,3,0,-3
16848,1,0,7,0,-7
16849,1,0,0,0,0
16850,0,0,38,0,-38
16851,1,0,73,0,-73
16852,0,0,4,0,-4
16853,0,0,14,0,-14
16854,1,1,220,1385,1165
16855,1,0,8,0,-8
16856,0,0,59,0,-59
16857,1,0,37,0,-37
16858,0,0,76,0,-76
16859,1,1,861,3119,2258
16860,0,0,54,0,-54
16861,0,0,154,0,-154
16862,0,0,44,0,-44
16863,0,0,20,0,-20
16864,1,1,295,1300,1005
16865,1,1,372,1219,847
16866,0,0,72,0,-72
16867,1,0,132,0,-132
16868,0,0,18,0,-18
16869,1,1,1413,1566,153
16870,0,0,34,0,-34
16871,1,1,40,1225,1185
16872,0,0,9,0,-9
16873,1,1,74,1201,1127
16874,1,0,18,0,-18
16875,1,1,342,1329,987
16876,1,1,264,1281,1017
16877,1,0,99,0,-99
16878,1,1,223,1941,1718
16879,1,1,1615,1227,-388
16880,0,0,116,0,-116
16881,1,0,4,0,-4
16882,1,1,743,1262,519
16883,0,0,38,0,-38
16884,1,0,24,0,-24
16885,0,0,165,0,-165
16886,1,0,61,0,-61
16887,1,1,542,1640,1098
16888,1,0,88,0,-88
16889,1,1,454,1415,961
16890,0,0,33,0,-33
16891,0,0,48,0,-48
16892,0,0,10,0,-10
16893,1,0,41,0,-41
16894,1,0,21,0,-21
16895,1,1,739,1388,649
16896,1,1,530,2978,2448
16897,1,1,80,1437,1357
16898,1,1,1196,1300,104
16899,1,1,578,1299,721
16900,1,1,66,1205,1139
16901,1,1,925,3683,2758
16902,0,0,101,0,-101
16903,0,0,41,0,-41
16904,0,0,42,0,-42
16905,0,0,54,0,-54
16906,1,0,59,0,-59
16907,1,1,325,2037,1712
16908,0,0,110,0,-110
16909,1,0,98,0,-98
16910,0,0,127,0,-127
16911,0,0,40,0,-40
16912,1,1,351,1360,1009
16913,1,0,60,0,-60
16914,0,0,150,0,-150
16915,0,0,14,0,-14
16916,1,0,108,0,-108
16917,0,0,33,0,-33
16918,1,1,274,1273,999
16919,1,0,9,0,-9
16920,1,1,1530,1416,-114
16921,1,0,6,0,-6
16922,1,1,167,1237,1070
16923,1,1,723,1658,935
16924,0,0,141,0,-141
16925,1,0,2,0,-2
16926,1,0,72,0,-72
16927,0,0,0,0,0
16928,1,0,26,0,-26
16929,0,0,31,0,-31
16930,0,0,130,0,-130
16931,1,0,1,0,-1
16932,1,1,142,1276,1134
16933,1,0,21,0,-21
16934,1,0,113,0,-113
16935,0,0,150,0,-150
16936,0,0,0,0,0
16937,1,0,63,0,-63
16938,0,0,228,0,-228
16939,0,0,28,0,-28
16940,1,0,212,0,-212
16941,1,0,8,0,-8
16942,0,0,82,0,-82
16943,1,1,58,1215,1157
16944,0,0,108,0,-108
16945,1,0,62,0,-62
16946,1,0,45,0,-45
16947,1,1,237,1325,1088
16948,1,0,2,0,-2
16949,0,0,54,0,-54
16950,1,0,59,0,-59
16951,1,0,89,0,-89
16952,0,0,39,0,-39
16953,0,0,21,0,-21
16954,1,0,24,0,-24
16955,1,0,28,0,-28
16956,1,1,559,1430,871
16957,1,1,184,1502,1318
16958,1,0,72,0,-72
16959,1,0,27,0,-27
16960,1,0,47,0,-47
16961,1,1,458,1264,806
16962,1,0,8,0,-8
16963,1,1,463,1869,1406
16964,0,0,14,0,-14
16965,0,0,44,0,-44
16966,1,0,4,0,-4
16967,1,1,1223,1224,1
16968,1,1,518,1291,773
16969,1,0,157,0,-157
16970,1,1,125,1258,1133
16971,0,0,6,0,-6
16972,1,1,870,1318,448
16973,0,0,63,0,-63
16974,0,0,6,0,-6
16975,1,0,82,0,-82
16976,1,0,61,0,-61
16977,0,0,19,0,-19
16978,1,0,8,0,-8
16979,0,0,212,0,-212
16980,1,0,34,0,-34
16981,0,0,61,0,-61
16982,1,1,453,1686,1233
16983,1,1,487,1491,1004
16984,0,0,48,0,-48
16985,0,0,11,0,-11
16986,1,0,13,0,-13
16987,1,1,448,1672,1224
16988,1,1,45,1584,1539
16989,1,1,419,3881,3462
16990,0,0,10,0,-10
16991,0,0,4,0,-4
16992,1,1,1397,1204,-193
16993,0,0,50,0,-50
16994,0,0,65,0,-65
16995,1,0,71,0,-71
16996,0,0,190,0,-190
16997,1,1,972,1434,462
16998,0,0,61,0,-61
16999,1,1,135,1214,1079
17000,0,0,19,0,-19
17001,0,0,35,0,-35
17002,0,0,37,0,-37
17003,0,0,73,0,-73
17004,1,0,9,0,-9
17005,0,0,42,0,-42
17006,1,0,73,0,-73
17007,1,0,66,0,-66
17008,1,0,12,0,-12
17009,1,0,83,0,-83
17010,1,0,6,0,-6
17011,1,1,1421,1433,12
17012,0,0,59,0,-59
17013,0,0,13,0,-13
17014,0,0,81,0,-81
17015,1,1,1098,1365,267
17016,1,0,19,0,-19
17017,1,1,366,1262,896
17018,0,0,278,0,-278
17019,1,0,1,0,-1
17020,0,0,107,0,-107
17021,1,1,331,1362,1031
17022,1,1,1132,1204,72
17023,1,0,51,0,-51
17024,1,0,17,0,-17
17025,1,1,1003,2064,1061
17026,1,1,614,1225,611
17027,0,0,1,0,-1
17028,1,1,633,1203,570
17029,1,1,61,1204,1143
17030,1,0,19,0,-19
17031,1,1,976,1593,617
17032,0,0,169,0,-169
17033,1,1,113,1433,1320
17034,0,0,6,0,-6
17035,1,0,74,0,-74
17036,1,1,497,1535,1038
17037,1,0,5,0,-5
17038,0,0,15,0,-15
17039,0,0,62,0,-62
17040,1,1,300,1350,1050
17041,1,0,33,0,-33
17042,1,1,64,1828,1764
17043,0,0,74,0,-74
17044,1,0,20,0,-20
17045,0,0,44,0,-44
17046,1,0,124,0,-124
17047,1,1,635,1245,610
17048,1,0,89,0,-89
17049,0,0,95,0,-95
17050,1,0,3,0,-3
17051,1,0,201,0,-201
17052,1,0,2,0,-2
17053,1,0,18,0,-18
17054,1,1,37,1360,1323
17055,1,1,232,1362,1130
17056,1,0,66,0,-66
17057,0,0,7,0,-7
17058,0,0,7,0,-7
17059,0,0,43,0,-43
17060,0,0,23,0,-23
17061,0,0,109,0,-109
17062,0,0,54,0,-54
17063,0,0,37,0,-37
17064,0,0,50,0,-50
17065,0,0,34,0,-34
17066,1,0,57,0,-57
17067,1,0,9,0,-9
17068,1,1,451,1490,1039
17069,0,0,10,0,-10
17070,0,0,6,0,-6
17071,0,0,22,0,-22
17072,1,1,675,1680,1005
17073,0,0,42,0,-42
17074,0,0,50,0,-50
17075,1,0,81,0,-81
17076,0,0,23,0,-23
17077,0,0,6,0,-6
17078,1,0,21,0,-21
17079,1,1,216,1280,1064
17080,1,0,103,0,-103
17081,0,0,9,0,-9
17082,0,0,58,0,-58
17083,0,0,8,0,-8
17084,1,0,31,0,-31
17085,0,0,5,0,-5
17086,0,0,16,0,-16
17087,1,1,1044,1285,241
17088,0,0,60,0,-60
17089,1,1,692,1393,701
17090,1,1,1629,1591,-38
17091,0,0,12,0,-12
17092,1,1,1295,1574,279
17093,1,1,552,1778,1226
17094,0,0,99,0,-99
17095,1,0,10,0,-10
17096,1,0,9,0,-9
17097,1,1,175,1325,1150
17098,1,1,374,1280,906
17099,1,1,153,1214,1061
17100,0,0,12,0,-12
17101,0,0,134,0,-134
17102,1,0,112,0,-112
17103,1,1,155,1720,1565
17104,1,0,113,0,-113
17105,1,1,2062,1596,-466
17106,0,0,65,0,-65
17107,1,0,3,0,-3
17108,1,0,17,0,-17
17109,1,1,233,1342,1109
17110,0,0,37,0,-37
17111,1,1,358,1400,1042
17112,1,0,72,0,-72
17113,0,0,24,0,-24
17114,0,0,16,0,-16
17115,1,1,452,1342,890
17116,1,1,155,1608,1453
17117,1,1,171,2087,1916
17118,1,1,519,1214,695
17119,1,1,679,1276,597
17120,1,1,972,1245,273
17121,1,1,616,1330,714
17122,1,1,624,1336,712
17123,0,0,2,0,-2
17124,1,1,207,1366,1159
17125,1,0,86,0,-86
17126,1,1,271,1321,1050
17127,1,1,509,1336,827
17128,0,0,7,0,-7
17129,0,0,109,0,-109
17130,0,0,9,0,-9
17131,0,0,47,0,-47
17132,1,1,298,1251,953
17133,1,0,33,0,-33
17134,1,1,719,1371,652
17135,1,0,15,0,-15
17136,1,1,194,1338,1144
17137,0,0,143,0,-143
17138,0,0,56,0,-56
17139,1,0,28,0,-28
17140,1,1,127,2221,2094
17141,1,1,61,2193,2132
17142,1,0,1,0,-1
17143,0,0,16,0,-16
17144,1,1,607,1314,707
17145,0,0,34,0,-34
17146,1,0,5,0,-5
17147,0,0,84,0,-84
17148,0,0,0,0,0
17149,0,0,11,0,-11
17150,0,0,73,0,-73
17151,0,0,92,0,-92
17152,1,1,483,1721,1238
17153,1,1,770,1350,580
17154,0,0,15,0,-15
17155,1,1,731,1553,822
17156,1,0,76,0,-76
17157,0,0,14,0,-14
17158,0,0,99,0,-99
17159,1,1,1339,1419,80
17160,0,0,3,0,-3
17161,1,1,318,1498,1180
17162,1,1,234,1812,1578
17163,0,0,68,0,-68
17164,1,0,5,0,-5
17165,1,1,1047,2946,1899
17166,1,0,10,0,-10
17167,1,1,93,1224,1131
17168,0,0,62,0,-62
17169,0,0,294,0,-294
17170,0,0,8,0,-8
17171,0,0,134,0,-134
17172,1,1,345,3254,2909
17173,1,1,964,1513,549
17174,1,1,102,2001,1899
17175,1,0,43,0,-43
17176,1,1,240,1209,969
17177,1,0,42,0,-42
17178,1,0,18,0,-18
17179,1,0,4,0,-4
17180,1,0,43,0,-43
17181,1,0,57,0,-57
17182,0,0,97,0,-97
17183,1,0,9,0,-9
17184,1,0,146,0,-146
17185,1,1,679,1432,753
17186,0,0,98,0,-98
17187,1,0,46,0,-46
17188,0,0,109,0,-109
17189,0,0,129,0,-129
17190,0,0,22,0,-22
17191,0,0,36,0,-36
17192,0,0,56,0,-56
17193,1,1,1114,1636,522
17194,1,0,45,0,-45
17195,1,1,293,1970,1677
17196,1,0,102,0,-102
17197,0,0,33,0,-33
17198,1,1,1189,1678,489
17199,1,0,0,0,0
17200,1,1,290,1833,1543
17201,0,0,53,0,-53
17202,0,0,43,0,-43
17203,1,1,595,1340,745
17204,0,0,0,0,0
17205,0,0,77,0,-77
17206,1,0,92,0,-92
17207,1,0,9,0,-9
17208,1,1,116,1611,1495
17209,0,0,23,0,-23
17210,1,0,0,0,0
17211,0,0,21,0,-21
17212,0,0,11,0,-11
17213,0,0,93,0,-93
17214,0,0,85,0,-85
17215,1,0,38,0,-38
17216,0,0,67,0,-67
17217,1,0,29,0,-29
17218,1,1,277,1267,990
17219,1,0,15,0,-15
17220,0,0,143,0,-143
17221,0,0,34,0,-34
17222,1,1,797,1648,851
17223,1,0,81,0,-81
17224,1,0,12,0,-12
17225,1,0,112,0,-112
17226,1,0,275,0,-275
17227,1,0,12,0,-12
17228,1,0,156,0,-156
17229,1,0,37,0,-37
17230,0,0,19,0,-19
17231,1,0,8,0,-8
17232,1,1,157,1382,1225
17233,0,0,179,0,-179
17234,0,0,2,0,-2
17235,1,1,666,1520,854
17236,0,0,15,0,-15
17237,1,1,2059,1284,-775
17238,1,1,631,1251,620
17239,0,0,2,0,-2
17240,0,0,22,0,-22
17241,1,0,5,0,-5
17242,1,1,512,2038,1526
17243,0,0,43,0,-43
17244,0,0,45,0,-45
17245,1,0,43,0,-43
17246,0,0,52,0,-52
17247,0,0,120,0,-120
17248,1,1,473,1259,786
17249,1,0,33,0,-33
17250,1,1,31,1204,1173
17251,0,0,56,0,-56
17252,0,0,32,0,-32
17253,1,0,5,0,-5
17254,0,0,1,0,-1
17255,1,1,14,1381,1367
17256,1,1,391,1266,875
17257,0,0,99,0,-99
17258,1,0,17,0,-17
17259,0,0,60,0,-60
17260,1,0,57,0,-57
17261,0,0,10,0,-10
17262,1,0,1,0,-1
17263,1,0,85,0,-85
17264,0,0,20,0,-20
17265,1,1,417,1691,1274
17266,0,0,3,0,-3
17267,1,1,158,1233,1075
17268,1,0,10,0,-10
17269,1,0,95,0,-95
17270,1,0,68,0,-68
17271,1,1,38,1273,1235
17272,1,0,61,0,-61
17273,0,0,50,0,-50
17274,1,1,334,1297,963
17275,0,0,12,0,-12
17276,0,0,28,0,-28
17277,0,0,82,0,-82
17278,1,0,0,0,0
17279,0,0,50,0,-50
17280,0,0,50,0,-50
17281,1,0,257,0,-257
17282,0,0,31,0,-31
17283,1,1,411,2460,2049
17284,1,0,20,0,-20
17285,0,0,2,0,-2
17286,1,0,82,0,-82
17287,0,0,176,0,-176
17288,1,1,63,1506,1443
17289,1,0,17,0,-17
17290,0,0,25,0,-25
17291,1,0,29,0,-29
17292,0,0,0,0,0
17293,0,0,0,0,0
17294,1,0,42,0,-42
17295,1,1,311,1286,975
17296,1,0,39,0,-39
17297,1,1,833,1511,678
17298,0,0,25,0,-25
17299,1,1,2103,1579,-524
17300,1,0,3,0,-3
17301,1,0,39,0,-39
17302,1,0,73,0,-73
17303,1,1,231,4778,4547
17304,0,0,2,0,-2
17305,0,0,85,0,-85
17306,1,0,34,0,-34
17307,0,0,48,0,-48
17308,1,0,5,0,-5
17309,1,0,33,0,-33
17310,0,0,2,0,-2
17311,1,0,4,0,-4
17312,0,0,1,0,-1
17313,1,0,19,0,-19
17314,0,0,43,0,-43
17315,0,0,16,0,-16
17316,0,0,76,0,-76
17317,1,0,118,0,-118
17318,1,1,878,1453,575
17319,0,0,29,0,-29
17320,1,1,641,1626,985
17321,1,0,14,0,-14
17322,1,0,79,0,-79
17323,1,0,50,0,-50
17324,0,0,238,0,-238
17325,0,0,108,0,-108
17326,0,0,15,0,-15
17327,0,0,27,0,-27
17328,0,0,70,0,-70
17329,0,0,129,0,-129
17330,1,0,155,0,-155
17331,0,0,42,0,-42
17332,0,0,48,0,-48
17333,0,0,26,0,-26
17334,1,1,1258,1349,91
17335,1,0,20,0,-20
17336,1,0,1,0,-1
17337,1,0,7,0,-7
17338,1,1,331,1393,1062
17339,1,0,65,0,-65
17340,1,0,35,0,-35
17341,1,0,201,0,-201
17342,0,0,37,0,-37
17343,1,0,285,0,-285
17344,1,0,1,0,-1
17345,0,0,18,0,-18
17346,0,0,18,0,-18
17347,1,1,1756,1266,-490
17348,1,1,279,1353,1074
17349,0,0,11,0,-11
17350,1,0,36,0,-36
17351,1,1,1958,1601,-357
17352,0,0,152,0,-152
17353,1,1,425,1228,803
17354,0,0,238,0,-238
17355,1,0,11,0,-11
17356,1,1,250,1309,1059
17357,1,1,1187,1305,118
17358,0,0,23,0,-23
17359,1,1,125,1638,1513
17360,0,0,49,0,-49
17361,1,0,111,0,-111
17362,0,0,76,0,-76
17363,1,0,23,0,-23
17364,1,1,294,1502,1208
17365,0,0,90,0,-90
17366,0,0,8,0,-8
17367,1,1,435,1376,941
17368,0,0,47,0,-47
17369,1,1,659,2024,1365
17370,1,1,156,1404,1248
17371,1,1,121,1400,1279
17372,1,0,168,0,-168
17373,1,1,549,1757,1208
17374,1,1,558,3822,3264
17375,1,1,579,1422,843
17376,0,0,18,0,-18
17377,1,0,23,0,-23
17378,1,0,25,0,-25
17379,1,0,44,0,-44
17380,0,0,2,0,-2
17381,0,0,94,0,-94
17382,0,0,19,0,-19
17383,1,0,23,0,-23
17384,0,0,14,0,-14
17385,1,1,331,1450,1119
17386,0,0,12,0,-12
17387,1,0,40,0,-40
17388,1,0,108,0,-108
17389,0,0,9,0,-9
17390,1,1,122,1376,1254
17391,1,0,58,0,-58
17392,1,1,161,1240,1079
17393,1,0,55,0,-55
17394,1,1,1056,1229,173
17395,1,1,4,1332,1328
17396,0,0,30,0,-30
17397,0,0,28,0,-28
17398,0,0,22,0,-22
17399,1,1,434,4153,3719
17400,1,0,70,0,-70
17401,1,0,55,0,-55
17402,1,0,47,0,-47
17403,1,1,813,1406,593
17404,1,0,22,0,-22
17405,1,1,289,1235,946
17406,1,1,150,1268,1118
17407,1,0,4,0,-4
17408,0,0,19,0,-19
17409,0,0,46,0,-46
17410,0,0,18,0,-18
17411,0,0,49,0,-49
17412,1,1,721,2092,1371
17413,1,1,677,1564,887
17414,0,0,14,0,-14
17415,1,0,55,0,-55
17416,1,1,677,1935,1258
17417,1,0,173,0,-173
17418,0,0,8,0,-8
17419,1,1,27,1380,1353
17420,1,1,627,1368,741
17421,0,0,33,0,-33
17422,0,0,12,0,-12
17423,1,0,8,0,-8
17424,0,0,81,0,-81
17425,1,0,20,0,-20
17426,1,0,3,0,-3
17427,1,0,153,0,-153
17428,0,0,19,0,-19
17429,0,0,19,0,-19
17430,1,0,110,0,-110
17431,1,1,1075,1464,389
17432,1,1,916,1214,298
17433,0,0,22,0,-22
17434,0,0,42,0,-42
17435,0,0,12,0,-12
17436,0,0,23,0,-23
17437,0,0,142,0,-142
17438,0,0,60,0,-60
17439,1,0,185,0,-185
17440,0,0,2,0,-2
17441,0,0,40,0,-40
17442,1,1,118,1412,1294
17443,0,0,35,0,-35
17444,1,1,202,1290,1088
17445,1,1,18,1570,1552
17446,1,0,107,0,-107
17447,0,0,41,0,-41
17448,1,1,561,1710,1149
17449,1,0,125,0,-125
17450,1,0,4,0,-4
17451,0,0,4,0,-4
17452,1,1,277,1622,1345
17453,1,0,84,0,-84
17454,0,0,62,0,-62
17455,1,1,1442,1238,-204
17456,1,0,31,0,-31
17457,0,0,26,0,-26
17458,0,0,14,0,-14
17459,0,0,32,0,-32
17460,0,0,58,0,-58
17461,1,0,22,0,-22
17462,0,0,31,0,-31
17463,0,0,35,0,-35
17464,0,0,29,0,-29
17465,0,0,79,0,-79
17466,1,0,85,0,-85
17467,1,1,1300,1436,136
17468,1,1,64,1276,1212
17469,0,0,23,0,-23
17470,1,1,1932,1720,-212
17471,1,1,2694,1229,-1465
17472,0,0,1,0,-1
17473,1,1,461,1208,747
17474,0,0,10,0,-10
17475,0,0,40,0,-40
17476,0,0,90,0,-90
17477,1,1,172,1431,1259
17478,0,0,6,0,-6
17479,1,1,1244,3241,1997
17480,1,1,86,2330,2244
17481,1,0,20,0,-20
17482,1,1,337,2017,1680
17483,0,0,18,0,-18
17484,0,0,58,0,-58
17485,0,0,94,0,-94
17486,1,0,12,0,-12
17487,0,0,217,0,-217
17488,0,0,1,0,-1
17489,1,1,620,1410,790
17490,1,1,321,1281,960
17491,1,1,111,1213,1102
17492,0,0,69,0,-69
17493,0,0,84,0,-84
17494,1,1,166,1251,1085
17495,1,1,395,1355,960
17496,1,1,1026,1207,181
17497,1,0,8,0,-8
17498,0,0,161,0,-161
17499,1,0,22,0,-22
17500,1,1,116,1238,1122
17501,1,0,22,0,-22
17502,0,0,63,0,-63
17503,1,1,1127,1366,239
17504,1,0,8,0,-8
17505,0,0,4,0,-4
17506,1,1,242,1305,1063
17507,1,1,824,1627,803
17508,1,1,62,1681,1619
17509,1,1,347,1235,888
17510,1,1,3491,1605,-1886
17511,1,1,3189,1272,-1917
17512,1,0,11,0,-11
17513,0,0,22,0,-22
17514,1,0,145,0,-145
17515,1,0,18,0,-18
17516,0,0,6,0,-6
17517,0,0,60,0,-60
17518,0,0,18,0,-18
17519,1,1,657,1225,568
17520,1,1,226,1780,1554
17521,1,0,16,0,-16
17522,1,1,234,1962,1728
17523,0,0,29,0,-29
17524,1,0,10,0,-10
17525,1,1,322,1314,992
17526,1,1,102,1517,1415
17527,0,0,48,0,-48
17528,1,0,17,0,-17
17529,0,0,27,0,-27
17530,0,0,27,0,-27
17531,1,1,528,1213,685
17532,1,0,2,0,-2
17533,0,0,101,0,-101
17534,1,0,24,0,-24
17535,0,0,24,0,-24
17536,1,1,262,1214,952
17537,1,0,15,0,-15
17538,0,0,23,0,-23
17539,1,1,422,1405,983
17540,0,0,8,0,-8
17541,1,1,99,3063,2964
17542,1,0,32,0,-32
17543,0,0,43,0,-43
17544,1,1,617,1271,654
17545,0,0,86,0,-86
17546,0,0,17,0,-17
17547,1,0,2,0,-2
17548,1,1,1059,2406,1347
17549,1,0,53,0,-53
17550,1,1,1331,1372,41
17551,0,0,11,0,-11
17552,1,0,165,0,-165
17553,1,1,472,1324,852
17554,1,1,404,1298,894
17555,1,1,567,1362,795
17556,0,0,25,0,-25
17557,0,0,4,0,-4
17558,0,0,14,0,-14
17559,1,0,35,0,-35
17560,0,0,145,0,-145
17561,1,1,699,1314,615
17562,1,1,89,1229,1140
17563,1,0,157,0,-157
17564,1,1,385,2497,2112
17565,0,0,99,0,-99
17566,1,1,78,1231,1153
17567,0,0,0,0,0
17568,1,0,78,0,-78
17569,1,1,684,1260,576
17570,1,1,1438,1385,-53
17571,0,0,172,0,-172
17572,0,0,94,0,-94
17573,0,0,51,0,-51
17574,0,0,201,0,-201
17575,1,0,24,0,-24
17576,1,0,13,0,-13
17577,0,0,55,0,-55
17578,1,0,87,0,-87
17579,0,0,99,0,-99
17580,0,0,77,0,-77
17581,0,0,31,0,-31
17582,0,0,5,0,-5
17583,1,1,384,1696,1312
17584,1,1,239,1401,1162
17585,1,0,26,0,-26
17586,1,0,8,0,-8
17587,0,0,78,0,-78
17588,1,1,306,1374,1068
17589,0,0,26,0,-26
17590,0,0,2,0,-2
17591,1,1,682,2415,1733
17592,0,0,2,0,-2
17593,1,1,1818,2329,511
17594,0,0,54,0,-54
17595,0,0,25,0,-25
17596,0,0,28,0,-28
17597,1,0,104,0,-104
17598,0,0,25,0,-25
17599,0,0,34,0,-34
17600,1,1,463,1421,958
17601,0,0,7,0,-7
17602,1,1,937,1213,276
17603,1,0,14,0,-14
17604,1,0,5,0,-5
17605,0,0,91,0,-91
17606,1,0,45,0,-45
17607,0,0,68,0,-68
17608,1,0,23,0,-23
17609,1,0,57,0,-57
17610,1,1,1259,1518,259
17611,0,0,28,0,-28
17612,1,1,555,1356,801
17613,1,0,138,0,-138
17614,0,0,239,0,-239
17615,1,0,45,0,-45
17616,1,1,538,1204,666
17617,1,0,54,0,-54
17618,1,1,125,1234,1109
17619,1,1,53,3224,3171
17620,1,0,88,0,-88
17621,1,0,8,0,-8
17622,0,0,60,0,-60
17623,1,1,49,1700,1651
17624,1,0,17,0,-17
17625,1,0,207,0,-207
17626,0,0,59,0,-59
17627,1,0,91,0,-91
17628,0,0,159,0,-159
17629,1,1,451,1432,981
17630,1,0,14,0,-14
17631,1,1,390,1282,892
17632,1,1,25,1225,1200
17633,0,0,46,0,-46
17634,1,1,916,1253,337
17635,1,0,52,0,-52
17636,1,1,428,1253,825
17637,1,1,532,1410,878
17638,1,0,15,0,-15
17639,0,0,100,0,-100
17640,1,0,27,0,-27
17641,0,0,5,0,-5
17642,1,0,80,0,-80
17643,0,0,77,0,-77
17644,1,1,795,1219,424
17645,1,1,736,1647,911
17646,0,0,101,0,-101
17647,1,1,135,1241,1106
17648,1,1,443,1229,786
17649,1,0,27,0,-27
17650,1,1,348,1330,982
17651,1,0,17,0,-17
17652,1,0,147,0,-147
17653,0,0,97,0,-97
17654,1,1,882,1221,339
17655,1,0,137,0,-137
17656,0,0,111,0,-111
17657,1,1,522,1559,1037
17658,1,1,409,1360,951
17659,1,1,101,1624,1523
17660,1,0,73,0,-73
17661,1,0,128,0,-128
17662,0,0,5,0,-5
17663,1,1,419,2689,2270
17664,0,0,31,0,-31
17665,0,0,17,0,-17
17666,0,0,65,0,-65
17667,1,1,37,1742,1705
17668,0,0,88,0,-88
17669,1,1,1257,3234,1977
17670,1,1,503,1300,797
17671,0,0,98,0,-98
17672,0,0,38,0,-38
17673,1,0,79,0,-79
17674,0,0,25,0,-25
17675,0,0,32,0,-32
17676,0,0,17,0,-17
17677,1,0,1,0,-1
17678,0,0,77,0,-77
17679,0,0,106,0,-106
17680,0,0,23,0,-23
17681,1,1,1021,1258,237
17682,1,1,1922,1726,-196
17683,1,0,71,0,-71
17684,0,0,9,0,-9
17685,0,0,21,0,-21
17686,0,0,20,0,-20
17687,1,0,25,0,-25
17688,0,0,158,0,-158
17689,0,0,20,0,-20
17690,1,0,320,0,-320
17691,1,0,74,0,-74
17692,1,0,7,0,-7
17693,1,1,606,1342,736
17694,1,0,125,0,-125
17695,1,1,281,1585,1304
17696,0,0,84,0,-84
17697,0,0,0,0,0
17698,0,0,14,0,-14
17699,0,0,47,0,-47
17700,1,0,14,0,-14
17701,0,0,6,0,-6
17702,1,1,81,1990,1909
17703,0,0,11,0,-11
17704,0,0,45,0,-45
17705,1,0,44,0,-44
17706,0,0,27,0,-27
17707,0,0,35,0,-35
17708,1,1,813,1252,439
17709,1,1,120,1751,1631
17710,1,0,62,0,-62
17711,1,1,143,1403,1260
17712,0,0,97,0,-97
17713,1,0,47,0,-47
17714,1,0,15,0,-15
17715,0,0,51,0,-51
17716,1,0,46,0,-46
17717,1,0,45,0,-45
17718,1,1,2090,1247,-843
17719,1,0,2,0,-2
17720,0,0,0,0,0
17721,0,0,2,0,-2
17722,1,0,27,0,-27
17723,0,0,57,0,-57
17724,1,0,2,0,-2
17725,0,0,50,0,-50
17726,0,0,53,0,-53
17727,0,0,99,0,-99
17728,1,0,97,0,-97
17729,1,1,117,1769,1652
17730,1,0,57,0,-57
17731,0,0,19,0,-19
17732,0,0,14,0,-14
17733,1,0,19,0,-19
17734,0,0,17,0,-17
17735,1,1,588,1564,976
17736,0,0,82,0,-82
17737,0,0,100,0,-100
17738,0,0,2,0,-2
17739,1,1,554,1355,801
17740,0,0,0,0,0
17741,1,1,2334,1465,-869
17742,1,0,139,0,-139
17743,1,0,75,0,-75
17744,0,0,54,0,-54
17745,1,1,506,1303,797
17746,0,0,99,0,-99
17747,1,0,6,0,-6
17748,1,1,206,1284,1078
17749,1,1,320,1334,1014
17750,1,0,29,0,-29
17751,1,1,1077,1604,527
17752,1,0,7,0,-7
17753,1,1,160,1265,1105
17754,1,0,11,0,-11
17755,1,1,972,1293,321
17756,0,0,14,0,-14
17757,1,1,700,2116,1416
17758,0,0,25,0,-25
17759,0,0,1,0,-1
17760,1,0,67,0,-67
17761,1,1,1415,1996,581
17762,1,1,977,1313,336
17763,1,1,657,1227,570
17764,0,0,44,0,-44
17765,1,1,37,1564,1527
17766,1,1,819,1215,396
17767,0,0,6,0,-6
17768,1,0,73,0,-73
17769,1,0,27,0,-27
17770,1,0,84,0,-84
17771,0,0,8,0,-8
17772,1,1,953,1265,312
17773,0,0,68,0,-68
17774,1,0,20,0,-20
17775,1,1,355,1487,1132
17776,0,0,32,0,-32
17777,0,0,13,0,-13
17778,1,0,21,0,-21
17779,1,1,476,1403,927
17780,1,1,411,2034,1623
17781,1,0,4,0,-4
17782,1,1,167,1761,1594
17783,1,0,40,0,-40
17784,0,0,69,0,-69
17785,0,0,48,0,-48
17786,0,0,19,0,-19
17787,1,0,34,0,-34
17788,1,0,98,0,-98
17789,1,0,12,0,-12
17790,1,1,176,1813,1637
17791,0,0,54,0,-54
17792,0,0,56,0,-56
17793,0,0,36,0,-36
17794,1,1,497,1202,705
17795,1,0,49,0,-49
17796,0,0,20,0,-20
17797,1,0,89,0,-89
17798,1,0,32,0,-32
17799,0,0,53,0,-53
17800,0,0,14,0,-14
17801,1,1,44,1314,1270
17802,1,1,1642,1478,-164
17803,1,1,237,1364,1127
17804,1,0,10,0,-10
17805,0,0,56,0,-56
17806,0,0,46,0,-46
17807,0,0,10,0,-10
17808,1,0,66,0,-66
17809,1,1,388,1682,1294
17810,1,1,733,1490,757
17811,1,1,511,1212,701
17812,0,0,12,0,-12
17813,0,0,11,0,-11
17814,1,0,82,0,-82
17815,1,1,476,1583,1107
17816,1,1,139,1580,1441
17817,0,0,88,0,-88
17818,1,0,20,0,-20
17819,0,0,42,0,-42
17820,0,0,34,0,-34
17821,1,0,101,0,-101
17822,1,1,1015,1378,363
17823,1,0,2,0,-2
17824,1,1,795,1264,469
17825,1,0,2,0,-2
17826,1,0,39,0,-39
17827,1,0,36,0,-36
17828,0,0,150,0,-150
17829,0,0,53,0,-53
17830,1,0,7,0,-7
17831,1,1,267,1364,1097
17832,0,0,13,0,-13
17833,1,1,675,1297,622
17834,0,0,5,0,-5
17835,1,0,88,0,-88
17836,1,0,72,0,-72
17837,1,1,240,1555,1315
17838,1,1,556,1254,698
17839,1,0,168,0,-168
17840,1,0,12,0,-12
17841,1,1,506,1427,921
17842,0,0,30,0,-30
17843,1,1,1922,1527,-395
17844,1,1,530,1200,670
17845,1,0,137,0,-137
17846,0,0,66,0,-66
17847,0,0,43,0,-43
17848,1,1,982,1347,365
17849,0,0,25,0,-25
17850,1,1,195,3110,2915
17851,1,0,16,0,-16
17852,1,1,247,5392,5145
17853,0,0,5,0,-5
17854,0,0,126,0,-126
17855,0,0,61,0,-61
17856,1,1,250,1334,1084
17857,0,0,9,0,-9
17858,1,1,188,1272,1084
17859,1,0,22,0,-22
17860,1,1,563,2777,2214
17861,1,1,238,1364,1126
17862,0,0,29,0,-29
17863,1,1,154,1236,1082
17864,1,0,42,0,-42
17865,0,0,13,0,-13
17866,0,0,71,0,-71
17867,1,1,229,2120,1891
17868,1,1,326,1791,1465
17869,0,0,78,0,-78
17870,0,0,96,0,-96
17871,0,0,3,0,-3
17872,0,0,6,0,-6
17873,0,0,120,0,-120
17874,1,0,26,0,-26
17875,0,0,56,0,-56
17876,0,0,21,0,-21
17877,0,0,28,0,-28
17878,1,1,389,1335,946
17879,1,1,148,1568,1420
17880,1,1,769,1654,885
17881,1,1,124,2982,2858
17882,1,0,97,0,-97
17883,1,1,368,1398,1030
17884,0,0,5,0,-5
17885,0,0,40,0,-40
17886,0,0,30,0,-30
17887,1,0,56,0,-56
17888,1,0,37,0,-37
17889,1,0,51,0,-51
17890,1,0,64,0,-64
17891,1,0,3,0,-3
17892,0,0,24,0,-24
17893,0,0,14,0,-14
17894,0,0,18,0,-18
17895,1,0,1,0,-1
17896,1,0,33,0,-33
17897,1,0,50,0,-50
17898,0,0,61,0,-61
17899,1,0,42,0,-42
17900,1,1,468,1443,975
17901,1,1,606,1275,669
17902,0,0,59,0,-59
17903,1,1,313,2054,1741
17904,1,1,114,1398,1284
17905,1,0,29,0,-29
17906,0,0,17,0,-17
17907,1,1,20,2324,2304
17908,1,0,85,0,-85
17909,0,0,10,0,-10
17910,1,1,525,1732,1207
17911,0,0,55,0,-55
17912,1,1,117,1576,1459
17913,0,0,34,0,-34
17914,0,0,62,0,-62
17915,1,0,67,0,-67
17916,1,0,229,0,-229
17917,0,0,37,0,-37
17918,0,0,3,0,-3
17919,0,0,40,0,-40
17920,1,0,21,0,-21
17921,1,0,2,0,-2
17922,1,0,14,0,-14
17923,0,0,8,0,-8
17924,1,1,170,1540,1370
17925,1,1,301,2335,2034
17926,0,0,23,0,-23
17927,0,0,76,0,-76
17928,1,0,23,0,-23
17929,0,0,31,0,-31
17930,1,0,13,0,-13
17931,0,0,40,0,-40
17932,1,0,112,0,-112
17933,1,0,18,0,-18
17934,1,1,465,1816,1351
17935,0,0,86,0,-86
17936,1,1,179,1380,1201
17937,1,1,123,1358,1235
17938,0,0,82,0,-82
17939,1,1,1201,1315,114
17940,1,1,1102,1465,363
17941,1,0,31,0,-31
17942,1,1,1114,2165,1051
17943,0,0,49,0,-49
17944,1,0,84,0,-84
17945,1,0,2,0,-2
17946,1,0,13,0,-13
17947,1,0,41,0,-41
17948,1,1,896,1204,308
17949,1,1,519,1242,723
17950,1,0,13,0,-13
17951,1,0,2,0,-2
17952,1,1,865,1396,531
17953,0,0,182,0,-182
17954,1,1,641,1877,1236
17955,1,1,2116,1420,-696
17956,0,0,12,0,-12
17957,1,0,46,0,-46
17958,0,0,50,0,-50
17959,0,0,68,0,-68
17960,0,0,107,0,-107
17961,1,0,19,0,-19
17962,0,0,48,0,-48
17963,0,0,12,0,-12
17964,1,1,102,1719,1617
17965,0,0,99,0,-99
17966,1,1,95,1624,1529
17967,1,0,73,0,-73
17968,1,0,21,0,-21
17969,1,0,21,0,-21
17970,0,0,79,0,-79
17971,0,0,85,0,-85
17972,0,0,81,0,-81
17973,1,1,493,1499,1006
17974,1,1,97,1655,1558
17975,0,0,33,0,-33
17976,1,1,499,1710,1211
17977,0,0,32,0,-32
17978,1,0,60,0,-60
17979,1,0,30,0,-30
17980,0,0,76,0,-76
17981,0,0,10,0,-10
17982,0,0,24,0,-24
17983,1,0,13,0,-13
17984,1,1,165,1362,1197
17985,1,0,4,0,-4
17986,0,0,9,0,-9
17987,1,0,105,0,-105
17988,0,0,126,0,-126
17989,1,0,52,0,-52
17990,0,0,110,0,-110
17991,0,0,118,0,-118
17992,0,0,51,0,-51
17993,0,0,33,0,-33
17994,1,0,6,0,-6
17995,0,0,114,0,-114
17996,0,0,73,0,-73
17997,1,0,7,0,-7
17998,1,0,23,0,-23
17999,0,0,125,0,-125
18000,1,1,494,1764,1270
18001,1,0,33,0,-33
18002,1,1,139,1792,1653
18003,1,1,195,1227,1032
18004,0,0,0,0,0
18005,0,0,148,0,-148
18006,0,0,50,0,-50
18007,1,0,22,0,-22
18008,0,0,40,0,-40
18009,1,1,355,1577,1222
18010,1,0,34,0,-34
18011,1,0,28,0,-28
18012,1,1,382,2274,1892
18013,1,1,237,1313,1076
18014,0,0,37,0,-37
18015,1,0,128,0,-128
18016,0,0,135,0,-135
18017,0,0,89,0,-89
18018,1,1,657,1568,911
18019,1,0,60,0,-60
18020,1,1,271,1232,961
18021,1,1,23,2362,2339
18022,0,0,27,0,-27
18023,0,0,41,0,-41
18024,0,0,64,0,-64
18025,1,0,4,0,-4
18026,0,0,4,0,-4
18027,0,0,122,0,-122
18028,0,0,54,0,-54
18029,1,1,1167,1634,467
18030,1,1,545,1552,1007
18031,1,1,191,1521,1330
18032,0,0,140,0,-140
18033,1,0,78,0,-78
18034,0,0,42,0,-42
18035,0,0,79,0,-79
18036,1,0,63,0,-63
18037,0,0,7,0,-7
18038,1,0,29,0,-29
18039,1,0,10,0,-10
18040,0,0,45,0,-45
18041,0,0,17,0,-17
18042,1,0,17,0,-17
18043,1,1,401,1799,1398
18044,0,0,87,0,-87
18045,1,1,594,1571,977
18046,0,0,11,0,-11
18047,1,0,59,0,-59
18048,1,0,109,0,-109
18049,1,0,81,0,-81
18050,1,0,22,0,-22
18051,1,0,10,0,-10
18052,1,1,224,1231,1007
18053,0,0,43,0,-43
18054,0,0,9,0,-9
18055,1,1,164,1306,1142
18056,1,0,2,0,-2
18057,0,0,110,0,-110
18058,1,0,13,0,-13
18059,1,0,54,0,-54
18060,1,1,403,1442,1039
18061,1,0,35,0,-35
18062,1,1,223,1454,1231
18063,0,0,64,0,-64
18064,1,0,5,0,-5
18065,0,0,106,0,-106
18066,0,0,8,0,-8
18067,1,1,993,3033,2040
18068,0,0,87,0,-87
18069,1,0,59,0,-59
18070,1,1,1131,1395,264
18071,1,1,647,1249,602
18072,0,0,23,0,-23
18073,0,0,21,0,-21
18074,1,0,106,0,-106
18075,1,1,87,1273,1186
18076,1,1,521,1365,844
18077,0,0,11,0,-11
18078,1,0,32,0,-32
18079,1,0,11,0,-11
18080,1,0,12,0,-12
18081,0,0,20,0,-20
18082,0,0,0,0,0
18083,0,0,57,0,-57
18084,1,0,11,0,-11
18085,1,0,190,0,-190
18086,1,0,48,0,-48
18087,0,0,25,0,-25
18088,1,0,75,0,-75
18089,0,0,57,0,-57
18090,0,0,14,0,-14
18091,0,0,25,0,-25
18092,1,1,237,1244,1007
18093,1,0,2,0,-2
18094,1,0,142,0,-142
18095,1,0,3,0,-3
18096,1,0,23,0,-23
18097,0,0,8,0,-8
18098,1,1,716,1863,1147
18099,1,1,125,1227,1102
18100,0,0,164,0,-164
18101,1,0,8,0,-8
18102,1,1,303,1604,1301
18103,1,1,306,1398,1092
18104,1,0,34,0,-34
18105,1,1,316,1778,1462
18106,0,0,125,0,-125
18107,1,0,93,0,-93
18108,0,0,13,0,-13
18109,0,0,4,0,-4
18110,1,1,133,1511,1378
18111,0,0,15,0,-15
18112,1,0,16,0,-16
18113,1,1,1644,1879,235
18114,1,1,123,1224,1101
18115,0,0,40,0,-40
18116,1,0,100,0,-100
18117,1,0,5,0,-5
18118,1,1,75,1269,1194
18119,0,0,127,0,-127
18120,0,0,4,0,-4
18121,0,0,43,0,-43
18122,0,0,34,0,-34
18123,1,0,13,0,-13
18124,1,0,38,0,-38
18125,0,0,65,0,-65
18126,0,0,24,0,-24
18127,0,0,31,0,-31
18128,0,0,45,0,-45
18129,1,0,32,0,-32
18130,0,0,14,0,-14
18131,1,1,856,1313,457
18132,0,0,0,0,0
18133,1,1,663,2038,1375
18134,1,1,515,1456,941
18135,1,0,23,0,-23
18136,0,0,13,0,-13
18137,0,0,10,0,-10
18138,1,0,23,0,-23
18139,0,0,22,0,-22
18140,0,0,96,0,-96
18141,1,1,1158,1363,205
18142,1,1,1038,1815,777
18143,0,0,112,0,-112
18144,1,1,243,2312,2069
18145,0,0,187,0,-187
18146,1,0,82,0,-82
18147,0,0,72,0,-72
18148,1,1,947,1329,382
18149,1,0,5,0,-5
18150,1,1,731,1500,769
18151,0,0,1,0,-1
18152,1,0,27,0,-27
18153,1,1,1099,2149,1050
18154,1,1,1417,1509,92
18155,0,0,31,0,-31
18156,1,0,38,0,-38
18157,1,1,237,1338,1101
18158,1,1,169,1252,1083
18159,1,1,371,1530,1159
18160,1,0,36,0,-36
18161,0,0,23,0,-23
18162,1,0,19,0,-19
18163,0,0,52,0,-52
18164,1,1,266,2227,1961
18165,0,0,77,0,-77
18166,1,0,83,0,-83
18167,1,0,121,0,-121
18168,0,0,19,0,-19
18169,1,0,46,0,-46
18170,1,0,79,0,-79
18171,0,0,14,0,-14
18172,1,1,836,1576,740
18173,1,1,819,1454,635
18174,0,0,140,0,-140
18175,0,0,2,0,-2
18176,1,0,215,0,-215
18177,1,1,70,1361,1291
18178,0,0,23,0,-23
18179,1,1,318,1252,934
18180,0,0,49,0,-49
18181,0,0,25,0,-25
18182,0,0,37,0,-37
18183,0,0,79,0,-79
18184,0,0,7,0,-7
18185,1,0,4,0,-4
18186,0,0,37,0,-37
18187,0,0,85,0,-85
18188,1,1,81,1233,1152
18189,1,1,443,1512,1069
18190,1,0,9,0,-9
18191,1,0,8,0,-8
18192,1,1,445,1478,1033
18193,1,0,96,0,-96
18194,0,0,21,0,-21
18195,1,1,131,3528,3397
18196,1,0,102,0,-102
18197,1,1,9,1598,1589
18198,1,0,34,0,-34
18199,1,0,70,0,-70
18200,1,0,58,0,-58
18201,0,0,16,0,-16
18202,1,1,643,1888,1245
18203,0,0,25,0,-25
18204,1,0,10,0,-10
18205,1,0,35,0,-35
18206,0,0,58,0,-58
18207,0,0,2,0,-2
18208,1,1,86,1229,1143
18209,1,1,795,1225,430
18210,1,0,69,0,-69
18211,1,1,351,1279,928
18212,0,0,49,0,-49
18213,0,0,24,0,-24
18214,1,0,16,0,-16
18215,1,0,4,0,-4
18216,1,0,24,0,-24
18217,0,0,36,0,-36
18218,1,1,594,1208,614
18219,1,0,15,0,-15
18220,1,0,100,0,-100
18221,1,1,320,2236,1916
18222,0,0,20,0,-20
18223,1,1,3018,1211,-1807
18224,0,0,67,0,-67
18225,0,0,74,0,-74
18226,0,0,16,0,-16
18227,0,0,39,0,-39
18228,0,0,15,0,-15
18229,1,1,1577,2006,429
18230,0,0,6,0,-6
18231,0,0,71,0,-71
18232,1,0,106,0,-106
18233,0,0,27,0,-27
18234,1,1,844,2767,1923
18235,1,1,292,1697,1405
18236,1,1,452,1419,967
18237,0,0,119,0,-119
18238,0,0,51,0,-51
18239,1,1,453,2168,1715
18240,0,0,8,0,-8
18241,1,1,477,1411,934
18242,0,0,10,0,-10
18243,0,0,52,0,-52
18244,1,1,784,1321,537
18245,0,0,10,0,-10
18246,1,1,446,1278,832
18247,1,1,465,1461,996
18248,1,0,27,0,-27
18249,1,1,419,1230,811
18250,1,0,116,0,-116
18251,1,1,1458,1240,-218
18252,0,0,16,0,-16
18253,1,0,3,0,-3
18254,1,1,1001,1415,414
18255,0,0,55,0,-55
18256,1,1,185,1521,1336
18257,0,0,108,0,-108
18258,1,1,76,1760,1684
18259,1,1,187,1761,1574
18260,0,0,24,0,-24
18261,1,1,1542,1350,-192
18262,0,0,34,0,-34
18263,1,1,1401,1349,-52
18264,1,0,19,0,-19
18265,1,1,26,1332,1306
18266,1,0,16,0,-16
18267,0,0,62,0,-62
18268,0,0,78,0,-78
18269,1,1,728,1511,783
18270,1,1,1007,1238,231
18271,1,0,6,0,-6
18272,1,1,1782,1842,60
18273,1,0,39,0,-39
18274,1,1,648,1299,651
18275,1,1,205,1426,1221
18276,1,0,117,0,-117
18277,0,0,20,0,-20
18278,1,1,816,1292,476
18279,0,0,54,0,-54
18280,0,0,18,0,-18
18281,1,0,10,0,-10
18282,1,1,82,2644,2562
18283,1,1,64,1463,1399
18284,1,1,237,1800,1563
18285,0,0,48,0,-48
18286,1,1,547,1262,715
18287,1,0,43,0,-43
18288,1,1,350,1935,1585
18289,1,1,127,1295,1168
18290,1,1,353,1894,1541
18291,0,0,43,0,-43
18292,1,0,91,0,-91
18293,1,0,80,0,-80
18294,1,1,303,1488,1185
18295,1,0,33,0,-33
18296,1,0,11,0,-11
18297,0,0,151,0,-151
18298,0,0,21,0,-21
18299,1,1,1335,1245,-90
18300,0,0,78,0,-78
18301,0,0,16,0,-16
18302,1,1,1358,1464,106
18303,0,0,0,0,0
18304,1,0,157,0,-157
18305,0,0,154,0,-154
18306,1,0,65,0,-65
18307,1,0,10,0,-10
18308,1,0,52,0,-52
18309,0,0,71,0,-71
18310,1,1,1300,1373,73
18311,0,0,30,0,-30
18312,1,1,120,1277,1157
18313,1,1,52,1245,1193
18314,1,0,72,0,-72
18315,1,1,1135,1512,377
18316,1,1,504,1231,727
18317,1,1,349,1573,1224
18318,1,1,239,4594,4355
18319,1,0,40,0,-40
18320,0,0,25,0,-25
18321,1,0,28,0,-28
18322,0,0,24,0,-24
18323,1,1,899,1662,763
18324,1,0,111,0,-111
18325,1,1,25,1266,1241
18326,0,0,23,0,-23
18327,0,0,59,0,-59
18328,1,0,52,0,-52
18329,1,0,7,0,-7
18330,0,0,45,0,-45
18331,1,0,4,0,-4
18332,0,0,48,0,-48
18333,0,0,2,0,-2
18334,1,0,77,0,-77
18335,1,0,12,0,-12
18336,0,0,15,0,-15
18337,1,1,838,1688,850
18338,1,1,18,1368,1350
18339,1,0,12,0,-12
18340,1,0,73,0,-73
18341,1,1,524,1351,827
18342,1,1,157,1290,1133
18343,1,0,184,0,-184
18344,1,0,74,0,-74
18345,0,0,46,0,-46
18346,0,0,21,0,-21
18347,0,0,24,0,-24
18348,1,0,46,0,-46
18349,0,0,23,0,-23
18350,1,1,11,1319,1308
18351,1,1,83,1283,1200
18352,1,0,28,0,-28
18353,0,0,28,0,-28
18354,0,0,24,0,-24
18355,1,0,9,0,-9
18356,1,0,160,0,-160
18357,1,1,143,2160,2017
18358,1,0,153,0,-153
18359,0,0,2,0,-2
18360,1,0,64,0,-64
18361,1,0,21,0,-21
18362,1,1,230,2461,2231
18363,1,1,146,1597,1451
18364,0,0,5,0,-5
18365,1,0,41,0,-41
18366,1,1,262,1322,1060
18367,1,0,108,0,-108
18368,0,0,35,0,-35
18369,0,0,2,0,-2
18370,0,0,32,0,-32
18371,0,0,77,0,-77
18372,0,0,35,0,-35
18373,1,0,63,0,-63
18374,0,0,62,0,-62
18375,1,1,638,1353,715
18376,0,0,150,0,-150
18377,1,1,160,1834,1674
18378,1,1,1144,1202,58
18379,0,0,53,0,-53
18380,1,1,274,1225,951
18381,0,0,13,0,-13
18382,1,0,35,0,-35
18383,0,0,39,0,-39
18384,0,0,0,0,0
18385,1,1,1376,1423,47
18386,1,1,247,2383,2136
18387,1,1,558,1254,696
18388,1,1,99,1226,1127
18389,1,1,1012,5547,4535
18390,1,0,201,0,-201
18391,1,1,693,2083,1390
18392,1,0,53,0,-53
18393,1,0,0,0,0
18394,1,1,607,1488,881
18395,0,0,41,0,-41
18396,0,0,294,0,-294
18397,1,1,447,1206,759
18398,0,0,24,0,-24
18399,0,0,7,0,-7
18400,1,0,81,0,-81
18401,1,0,46,0,-46
18402,1,1,91,1335,1244
18403,0,0,55,0,-55
18404,1,0,1,0,-1
18405,1,1,668,1685,1017
18406,1,1,240,1354,1114
18407,1,1,124,1271,1147
18408,1,1,245,1648,1403
18409,1,0,25,0,-25
18410,1,0,15,0,-15
18411,0,0,54,0,-54
18412,0,0,19,0,-19
18413,0,0,48,0,-48
18414,0,0,70,0,-70
18415,1,0,131,0,-131
18416,1,0,10,0,-10
18417,0,0,18,0,-18
18418,1,0,18,0,-18
18419,1,0,4,0,-4
18420,0,0,1,0,-1
18421,1,0,13,0,-13
18422,1,1,744,1613,869
18423,0,0,8,0,-8
18424,1,0,103,0,-103
18425,1,1,640,2608,1968
18426,1,1,265,1569,1304
18427,1,1,522,2322,1800
18428,1,0,5,0,-5
18429,1,1,639,1616,977
18430,1,1,1578,1232,-346
18431,1,1,435,1395,960
18432,1,1,190,2172,1982
18433,0,0,53,0,-53
18434,0,0,12,0,-12
18435,1,1,581,1402,821
18436,1,1,626,1266,640
18437,0,0,31,0,-31
18438,1,1,60,1309,1249
18439,0,0,3,0,-3
18440,0,0,35,0,-35
18441,1,0,15,0,-15
18442,0,0,27,0,-27
18443,0,0,104,0,-104
18444,1,0,129,0,-129
18445,0,0,38,0,-38
18446,0,0,0,0,0
18447,1,0,34,0,-34
18448,1,0,64,0,-64
18449,1,0,120,0,-120
18450,1,0,104,0,-104
18451,0,0,137,0,-137
18452,1,1,264,1598,1334
18453,1,1,309,1412,1103
18454,1,1,778,1700,922
18455,1,1,2429,1725,-704
18456,1,0,4,0,-4
18457,1,1,853,1308,455
18458,1,0,40,0,-40
18459,1,0,3,0,-3
18460,1,0,5,0,-5
18461,1,1,619,1848,1229
18462,0,0,146,0,-146
18463,1,1,1907,1620,-287
18464,1,0,111,0,-111
18465,0,0,3,0,-3
18466,0,0,0,0,0
18467,1,0,37,0,-37
18468,1,0,67,0,-67
18469,1,1,188,1358,1170
18470,0,0,4,0,-4
18471,0,0,62,0,-62
18472,1,0,32,0,-32
18473,1,1,65,1203,1138
18474,1,0,32,0,-32
18475,1,1,1718,1354,-364
18476,1,1,72,1833,1761
18477,1,1,717,1506,789
18478,0,0,19,0,-19
18479,0,0,18,0,-18
18480,0,0,55,0,-55
18481,0,0,27,0,-27
18482,1,0,10,0,-10
18483,1,1,466,1203,737
18484,1,1,349,1334,985
18485,0,0,140,0,-140
18486,1,1,110,1268,1158
18487,1,0,50,0,-50
18488,0,0,13,0,-13
18489,0,0,75,0,-75
18490,0,0,32,0,-32
18491,1,0,14,0,-14
18492,0,0,35,0,-35
18493,1,0,36,0,-36
18494,0,0,54,0,-54
18495,1,0,54,0,-54
18496,1,1,107,1491,1384
18497,0,0,117,0,-117
18498,1,1,413,1387,974
18499,0,0,22,0,-22
18500,0,0,5,0,-5
18501,1,1,171,1528,1357
18502,0,0,33,0,-33
18503,1,0,107,0,-107
18504,1,1,713,1343,630
18505,1,0,42,0,-42
18506,0,0,54,0,-54
18507,0,0,72,0,-72
18508,0,0,59,0,-59
18509,0,0,12,0,-12
18510,1,0,28,0,-28
18511,0,0,23,0,-23
18512,1,0,4,0,-4
18513,0,0,75,0,-75
18514,0,0,4,0,-4
18515,1,0,51,0,-51
18516,0,0,22,0,-22
18517,1,1,569,1277,708
18518,0,0,41,0,-41
18519,1,1,693,2742,2049
18520,1,0,29,0,-29
18521,1,0,83,0,-83
18522,0,0,39,0,-39
18523,0,0,0,0,0
18524,1,0,25,0,-25
18525,1,1,581,1222,641
18526,0,0,18,0,-18
18527,0,0,4,0,-4
18528,1,1,642,1927,1285
18529,1,0,43,0,-43
18530,1,0,33,0,-33
18531,1,1,559,1665,1106
18532,1,1,323,1306,983
18533,1,1,2209,1286,-923
18534,1,1,2303,2394,91
18535,0,0,10,0,-10
18536,0,0,40,0,-40
18537,0,0,20,0,-20
18538,1,0,12,0,-12
18539,1,0,120,0,-120
18540,0,0,5,0,-5
18541,1,0,98,0,-98
18542,0,0,2,0,-2
18543,1,0,28,0,-28
18544,1,0,43,0,-43
18545,0,0,15,0,-15
18546,0,0,108,0,-108
18547,0,0,27,0,-27
18548,1,0,17,0,-17
18549,1,1,63,1271,1208
18550,1,1,111,1388,1277
18551,0,0,101,0,-101
18552,1,0,41,0,-41
18553,0,0,142,0,-142
18554,1,1,52,1288,1236
18555,1,1,160,1301,1141
18556,0,0,6,0,-6
18557,0,0,71,0,-71
18558,0,0,46,0,-46
18559,0,0,27,0,-27
18560,0,0,130,0,-130
18561,0,0,24,0,-24
18562,1,0,0,0,0
18563,0,0,1,0,-1
18564,1,1,208,1209,1001
18565,0,0,4,0,-4
18566,1,1,1723,2044,321
18567,0,0,55,0,-55
18568,0,0,120,0,-120
18569,1,0,5,0,-5
18570,1,1,434,1212,778
18571,1,0,39,0,-39
18572,1,0,32,0,-32
18573,0,0,21,0,-21
18574,0,0,20,0,-20
18575,0,0,48,0,-48
18576,0,0,47,0,-47
18577,0,0,8,0,-8
18578,0,0,58,0,-58
18579,1,0,5,0,-5
18580,0,0,12,0,-12
18581,0,0,13,0,-13
18582,0,0,69,0,-69
18583,0,0,103,0,-103
18584,1,0,45,0,-45
18585,1,1,1132,1351,219
18586,0,0,112,0,-112
18587,1,0,6,0,-6
18588,1,0,74,0,-74
18589,1,0,53,0,-53
18590,1,0,104,0,-104
18591,0,0,87,0,-87
18592,0,0,144,0,-144
18593,1,0,27,0,-27
18594,1,0,133,0,-133
18595,0,0,17,0,-17
18596,1,0,56,0,-56
18597,0,0,139,0,-139
18598,1,1,519,2460,1941
18599,0,0,9,0,-9
18600,1,1,1538,1459,-79
18601,1,1,878,2168,1290
18602,0,0,1,0,-1
18603,1,0,57,0,-57
18604,1,1,1403,1309,-94
18605,1,1,40,1581,1541
18606,1,0,10,0,-10
18607,0,0,17,0,-17
18608,1,1,345,1557,1212
18609,0,0,181,0,-181
18610,1,0,12,0,-12
18611,0,0,2,0,-2
18612,1,0,5,0,-5
18613,1,1,407,1347,940
18614,1,1,1805,1301,-504
18615,0,0,146,0,-146
18616,0,0,2,0,-2
18617,1,1,314,1360,1046
18618,0,0,1,0,-1
18619,0,0,28,0,-28
18620,1,1,590,1265,675
18621,1,0,14,0,-14
18622,1,1,473,1352,879
18623,1,1,257,2774,2517
18624,0,0,28,0,-28
18625,0,0,29,0,-29
18626,0,0,2,0,-2
18627,0,0,0,0,0
18628,0,0,16,0,-16
18629,0,0,17,0,-17
18630,1,1,33,1298,1265
18631,1,0,94,0,-94
18632,0,0,21,0,-21
18633,0,0,11,0,-11
18634,1,0,234,0,-234
18635,0,0,12,0,-12
18636,1,1,556,1529,973
18637,1,1,337,1357,1020
18638,1,1,49,1251,1202
18639,1,1,1164,1234,70
18640,1,0,18,0,-18
18641,1,0,4,0,-4
18642,0,0,58,0,-58
18643,0,0,16,0,-16
18644,1,1,371,1308,937
18645,0,0,47,0,-47
18646,1,1,46,4335,4289
18647,1,1,228,1399,1171
18648,0,0,8,0,-8
18649,1,1,279,1588,1309
18650,0,0,16,0,-16
18651,1,0,66,0,-66
18652,0,0,15,0,-15
18653,0,0,20,0,-20
18654,1,0,34,0,-34
18655,0,0,0,0,0
18656,0,0,2,0,-2
18657,1,0,0,0,0
18658,0,0,40,0,-40
18659,1,0,18,0,-18
18660,1,0,10,0,-10
18661,0,0,33,0,-33
18662,0,0,32,0,-32
18663,1,0,27,0,-27
18664,0,0,49,0,-49
18665,0,0,46,0,-46
18666,0,0,5,0,-5
18667,0,0,21,0,-21
18668,1,1,335,1350,1015
18669,0,0,11,0,-11
18670,0,0,35,0,-35
18671,0,0,36,0,-36
18672,1,1,353,1308,955
18673,0,0,1,0,-1
18674,1,0,118,0,-118
18675,0,0,162,0,-162
18676,0,0,54,0,-54
18677,1,1,577,1322,745
18678,0,0,6,0,-6
18679,1,0,6,0,-6
18680,1,1,734,1480,746
18681,1,0,7,0,-7
18682,1,0,13,0,-13
18683,1,1,635,1259,624
18684,0,0,179,0,-179
18685,1,0,3,0,-3
18686,1,0,45,0,-45
18687,1,1,831,1667,836
18688,1,1,870,1371,501
18689,0,0,4,0,-4
18690,0,0,83,0,-83
18691,1,0,59,0,-59
18692,1,1,366,1251,885
18693,1,0,4,0,-4
18694,1,0,8,0,-8
18695,0,0,11,0,-11
18696,0,0,53,0,-53
18697,1,1,1939,1905,-34
18698,1,1,803,1226,423
18699,1,1,98,2114,2016
18700,1,1,382,1965,1583
18701,1,0,159,0,-159
18702,0,0,165,0,-165
18703,1,0,49,0,-49
18704,0,0,70,0,-70
18705,0,0,79,0,-79
18706,1,0,14,0,-14
18707,1,1,240,1708,1468
18708,0,0,82,0,-82
18709,0,0,41,0,-41
18710,1,0,22,0,-22
18711,1,0,95,0,-95
18712,0,0,48,0,-48
18713,0,0,22,0,-22
18714,1,0,35,0,-35
18715,0,0,28,0,-28
18716,1,0,75,0,-75
18717,1,1,494,2532,2038
18718,0,0,50,0,-50
18719,0,0,39,0,-39
18720,1,0,20,0,-20
18721,1,1,1044,1225,181
18722,1,1,179,1222,1043
18723,1,1,654,1433,779
18724,0,0,23,0,-23
18725,1,1,300,1505,1205
18726,0,0,66,0,-66
18727,0,0,173,0,-173
18728,0,0,186,0,-186
18729,0,0,16,0,-16
18730,0,0,32,0,-32
18731,0,0,86,0,-86
18732,1,0,36,0,-36
18733,0,0,78,0,-78
18734,1,0,1,0,-1
18735,0,0,110,0,-110
18736,0,0,9,0,-9
18737,1,0,15,0,-15
18738,1,0,62,0,-62
18739,0,0,12,0,-12
18740,1,0,153,0,-153
18741,0,0,49,0,-49
18742,1,1,370,1235,865
18743,0,0,78,0,-78
18744,1,1,1371,1532,161
18745,0,0,35,0,-35
18746,1,0,45,0,-45
18747,0,0,0,0,0
18748,1,1,148,1533,1385
18749,1,0,35,0,-35
18750,0,0,34,0,-34
18751,1,0,76,0,-76
18752,1,0,47,0,-47
18753,0,0,73,0,-73
18754,1,0,77,0,-77
18755,1,1,52,1399,1347
18756,1,0,73,0,-73
18757,1,0,5,0,-5
18758,1,1,577,1731,1154
18759,0,0,42,0,-42
18760,0,0,9,0,-9
18761,1,0,45,0,-45
18762,1,1,394,1324,930
18763,1,1,122,1590,1468
18764,1,0,76,0,-76
18765,1,1,2580,1213,-1367
18766,0,0,42,0,-42
18767,0,0,37,0,-37
18768,1,1,493,1374,881
18769,1,0,6,0,-6
18770,1,0,82,0,-82
18771,1,0,39,0,-39
18772,1,0,45,0,-45
18773,0,0,91,0,-91
18774,1,1,71,1290,1219
18775,0,0,100,0,-100
18776,1,1,1226,1539,313
18777,1,1,386,1720,1334
18778,0,0,105,0,-105
18779,1,1,1727,1276,-451
18780,0,0,14,0,-14
18781,0,0,2,0,-2
18782,1,0,6,0,-6
18783,1,0,79,0,-79
18784,1,1,858,1208,350
18785,1,1,361,1866,1505
18786,1,1,230,1360,1130
18787,1,0,22,0,-22
18788,0,0,20,0,-20
18789,0,0,20,0,-20
18790,1,0,81,0,-81
18791,1,1,625,1635,1010
18792,1,1,270,1266,996
18793,0,0,173,0,-173
18794,0,0,11,0,-11
18795,0,0,1,0,-1
18796,1,1,1205,2447,1242
18797,0,0,13,0,-13
18798,1,0,53,0,-53
18799,0,0,39,0,-39
18800,0,0,6,0,-6
18801,0,0,45,0,-45
18802,0,0,20,0,-20
18803,0,0,28,0,-28
18804,0,0,13,0,-13
18805,1,0,32,0,-32
18806,1,0,15,0,-15
18807,0,0,14,0,-14
18808,1,1,1434,1732,298
18809,1,0,31,0,-31
18810,1,1,159,1410,1251
18811,0,0,27,0,-27
18812,1,0,1,0,-1
18813,0,0,2,0,-2
18814,1,1,852,1303,451
18815,1,1,29,1682,1653
18816,1,1,3213,1210,-2003
18817,1,1,159,1269,1110
18818,1,1,106,2254,2148
18819,1,1,58,2015,1957
18820,1,1,577,1272,695
18821,0,0,75,0,-75
18822,1,1,1092,2726,1634
18823,1,0,126,0,-126
18824,0,0,15,0,-15
18825,1,0,34,0,-34
18826,1,0,92,0,-92
18827,0,0,9,0,-9
18828,0,0,221,0,-221
18829,0,0,15,0,-15
18830,1,1,94,1910,1816
18831,1,0,73,0,-73
18832,0,0,84,0,-84
18833,0,0,71,0,-71
18834,1,1,420,1244,824
18835,1,1,432,1651,1219
18836,1,1,1725,2220,495
18837,0,0,30,0,-30
18838,1,0,0,0,0
18839,1,1,108,1696,1588
18840,0,0,100,0,-100
18841,1,0,21,0,-21
18842,0,0,170,0,-170
18843,0,0,5,0,-5
18844,1,1,257,1921,1664
18845,1,1,239,2602,2363
18846,1,0,58,0,-58
18847,1,0,8,0,-8
18848,1,1,1076,1628,552
18849,1,1,572,1581,1009
18850,1,1,659,1378,719
18851,0,0,73,0,-73
18852,0,0,145,0,-145
18853,0,0,28,0,-28
18854,0,0,46,0,-46
18855,1,1,477,1292,815
18856,0,0,33,0,-33
18857,0,0,24,0,-24
18858,1,0,0,0,0
18859,1,1,943,1309,366
18860,1,0,29,0,-29
18861,1,0,23,0,-23
18862,0,0,94,0,-94
18863,1,0,51,0,-51
18864,0,0,156,0,-156
18865,1,0,4,0,-4
18866,0,0,64,0,-64
18867,1,1,622,1500,878
18868,0,0,153,0,-153
18869,0,0,26,0,-26
18870,0,0,14,0,-14
18871,0,0,7,0,-7
18872,0,0,6,0,-6
18873,0,0,46,0,-46
18874,0,0,6,0,-6
18875,0,0,41,0,-41
18876,0,0,4,0,-4
18877,0,0,33,0,-33
18878,1,0,52,0,-52
18879,1,1,642,1757,1115
18880,1,1,258,1341,1083
18881,1,1,241,1467,1226
18882,0,0,16,0,-16
18883,0,0,184,0,-184
18884,0,0,62,0,-62
18885,1,1,178,1221,1043
18886,0,0,25,0,-25
18887,0,0,13,0,-13
18888,1,1,316,1522,1206
18889,1,0,52,0,-52
18890,0,0,40,0,-40
18891,0,0,21,0,-21
18892,1,0,220,0,-220
18893,1,1,1447,1756,309
18894,0,0,59,0,-59
18895,1,0,1,0,-1
18896,1,1,355,1636,1281
18897,1,0,51,0,-51
18898,0,0,32,0,-32
18899,0,0,127,0,-127
18900,0,0,53,0,-53
18901,1,0,52,0,-52
18902,1,0,17,0,-17
18903,1,0,47,0,-47
18904,1,0,17,0,-17
18905,0,0,46,0,-46
18906,1,1,220,1344,1124
18907,1,1,781,1769,988
18908,0,0,19,0,-19
18909,1,0,67,0,-67
18910,0,0,14,0,-14
18911,0,0,16,0,-16
18912,1,1,213,1972,1759
18913,0,0,20,0,-20
18914,0,0,0,0,0
18915,1,1,378,1400,1022
18916,1,1,919,2410,1491
18917,1,0,12,0,-12
18918,1,1,203,1686,1483
18919,0,0,52,0,-52
18920,0,0,58,0,-58
18921,0,0,100,0,-100
18922,1,0,79,0,-79
18923,1,0,41,0,-41
18924,1,0,111,0,-111
18925,1,0,75,0,-75
18926,1,1,1671,1356,-315
18927,0,0,13,0,-13
18928,1,0,23,0,-23
18929,0,0,54,0,-54
18930,1,0,34,0,-34
18931,0,0,11,0,-11
18932,1,1,68,1594,1526
18933,1,1,775,1565,790
18934,0,0,90,0,-90
18935,1,1,293,1206,913
18936,1,0,1,0,-1
18937,1,1,489,1762,1273
18938,0,0,19,0,-19
18939,1,1,141,1216,1075
18940,1,1,1119,1724,605
18941,0,0,48,0,-48
18942,0,0,29,0,-29
18943,1,1,1832,1352,-480
18944,1,1,95,1363,1268
18945,1,1,1682,1786,104
18946,0,0,33,0,-33
18947,1,1,163,1395,1232
18948,0,0,9,0,-9
18949,1,0,26,0,-26
18950,0,0,21,0,-21
18951,0,0,43,0,-43
18952,0,0,78,0,-78
18953,0,0,103,0,-103
18954,1,0,37,0,-37
18955,0,0,58,0,-58
18956,1,0,274,0,-274
18957,0,0,6,0,-6
18958,0,0,18,0,-18
18959,1,0,24,0,-24
18960,1,1,294,1533,1239
18961,1,0,107,0,-107
18962,1,1,158,1511,1353
18963,0,0,12,0,-12
18964,1,0,51,0,-51
18965,1,0,156,0,-156
18966,1,1,206,1668,1462
18967,0,0,38,0,-38
18968,0,0,140,0,-140
18969,0,0,60,0,-60
18970,1,1,1535,1212,-323
18971,0,0,54,0,-54
18972,1,1,101,1242,1141
18973,1,1,353,1765,1412
18974,1,1,176,1293,1117
18975,1,0,124,0,-124
18976,0,0,38,0,-38
18977,1,0,122,0,-122
18978,1,0,90,0,-90
18979,1,0,98,0,-98
18980,1,1,323,1333,1010
18981,1,0,10,0,-10
18982,0,0,9,0,-9
18983,0,0,23,0,-23
18984,1,1,464,1505,1041
18985,1,1,932,1313,381
18986,1,0,4,0,-4
18987,0,0,14,0,-14
18988,1,0,136,0,-136
18989,1,0,3,0,-3
18990,1,1,1853,1995,142
18991,1,1,29,1725,1696
18992,0,0,6,0,-6
18993,1,0,66,0,-66
18994,0,0,13,0,-13
18995,0,0,29,0,-29
18996,1,0,179,0,-179
18997,0,0,120,0,-120
18998,0,0,7,0,-7
18999,0,0,40,0,-40
19000,1,0,5,0,-5
19001,1,0,16,0,-16
19002,1,1,61,1277,1216
19003,1,1,252,1318,1066
19004,1,1,1880,1368,-512
19005,1,1,87,1511,1424
19006,1,0,122,0,-122
19007,1,0,13,0,-13
19008,0,0,2,0,-2
19009,0,0,9,0,-9
19010,1,0,32,0,-32
19011,1,1,764,2046,1282
19012,1,1,315,1332,1017
19013,0,0,30,0,-30
19014,1,1,11,1289,1278
19015,0,0,27,0,-27
19016,0,0,82,0,-82
19017,1,0,64,0,-64
19018,1,0,92,0,-92
19019,1,1,2301,1216,-1085
19020,1,0,27,0,-27
19021,1,0,31,0,-31
19022,0,0,93,0,-93
19023,0,0,10,0,-10
19024,0,0,69,0,-69
19025,1,0,16,0,-16
19026,1,1,224,1629,1405
19027,1,0,2,0,-2
19028,0,0,69,0,-69
19029,1,1,71,1726,1655
19030,1,0,10,0,-10
19031,0,0,40,0,-40
19032,1,0,0,0,0
19033,1,0,1,0,-1
19034,1,0,30,0,-30
19035,0,0,225,0,-225
19036,1,0,1,0,-1
19037,0,0,18,0,-18
19038,1,1,1086,1331,245
19039,1,1,700,1202,502
19040,1,1,1074,1370,296
19041,0,0,79,0,-79
19042,0,0,25,0,-25
19043,1,0,48,0,-48
19044,0,0,46,0,-46
19045,0,0,65,0,-65
19046,1,0,49,0,-49
19047,1,1,136,1206,1070
19048,1,1,228,2511,2283
19049,1,0,1,0,-1
19050,0,0,149,0,-149
19051,1,1,717,1329,612
19052,0,0,55,0,-55
19053,1,1,51,2014,1963
19054,1,1,313,1237,924
19055,0,0,86,0,-86
19056,1,0,5,0,-5
19057,0,0,28,0,-28
19058,1,1,228,1829,1601
19059,1,1,537,1292,755
19060,1,0,57,0,-57
19061,0,0,68,0,-68
19062,0,0,5,0,-5
19063,1,0,36,0,-36
19064,0,0,92,0,-92
19065,1,0,71,0,-71
19066,1,0,28,0,-28
19067,0,0,72,0,-72
19068,1,0,321,0,-321
19069,1,1,53,2112,2059
19070,1,1,358,1874,1516
19071,1,1,174,1338,1164
19072,0,0,12,0,-12
19073,1,1,1673,1274,-399
19074,1,0,105,0,-105
19075,0,0,9,0,-9
19076,0,0,63,0,-63
19077,1,1,494,1205,711
19078,1,1,187,2192,2005
19079,0,0,26,0,-26
19080,1,0,41,0,-41
19081,1,1,867,1200,333
19082,0,0,9,0,-9
19083,0,0,35,0,-35
19084,0,0,32,0,-32
19085,1,1,275,1606,1331
19086,1,1,221,1468,1247
19087,1,1,63,1302,1239
19088,0,0,84,0,-84
19089,1,1,2159,2408,249
19090,1,1,697,1593,896
19091,0,0,5,0,-5
19092,0,0,51,0,-51
19093,1,1,346,1869,1523
19094,1,1,84,1533,1449
19095,1,0,33,0,-33
19096,0,0,13,0,-13
19097,0,0,0,0,0
19098,1,0,0,0,0
19099,1,1,169,1342,1173
19100,0,0,7,0,-7
19101,0,0,26,0,-26
19102,1,0,48,0,-48
19103,1,0,117,0,-117
19104,1,0,88,0,-88
19105,1,1,373,1721,1348
19106,1,1,536,1336,800
19107,0,0,39,0,-39
19108,0,0,22,0,-22
19109,1,0,3,0,-3
19110,1,0,8,0,-8
19111,0,0,26,0,-26
19112,1,1,86,1406,1320
19113,1,1,374,1388,1014
19114,1,1,579,1809,1230
19115,1,0,21,0,-21
19116,1,1,231,1275,1044
19117,0,0,23,0,-23
19118,1,1,91,1707,1616
19119,0,0,121,0,-121
19120,1,1,116,1654,1538
19121,1,1,558,1431,873
19122,1,1,255,2487,2232
19123,1,1,350,1380,1030
19124,0,0,45,0,-45
19125,1,1,60,1279,1219
19126,1,0,15,0,-15
19127,0,0,9,0,-9
19128,0,0,11,0,-11
19129,1,0,70,0,-70
19130,0,0,2,0,-2
19131,1,1,104,1269,1165
19132,0,0,40,0,-40
19133,0,0,10,0,-10
19134,0,0,149,0,-149
19135,0,0,10,0,-10
19136,1,0,30,0,-30
19137,1,1,626,2175,1549
19138,0,0,21,0,-21
19139,0,0,78,0,-78
19140,0,0,41,0,-41
19141,0,0,57,0,-57
19142,1,0,24,0,-24
19143,1,0,134,0,-134
19144,0,0,119,0,-119
19145,1,1,473,1229,756
19146,1,1,963,1433,470
19147,1,0,60,0,-60
19148,1,0,30,0,-30
19149,1,1,360,1287,927
19150,1,0,129,0,-129
19151,1,0,7,0,-7
19152,1,0,6,0,-6
19153,1,1,264,1852,1588
19154,0,0,8,0,-8
19155,1,1,797,1750,953
19156,1,1,3313,1680,-1633
19157,0,0,3,0,-3
19158,0,0,39,0,-39
19159,0,0,8,0,-8
19160,1,0,33,0,-33
19161,0,0,37,0,-37
19162,1,0,143,0,-143
19163,0,0,62,0,-62
19164,1,0,9,0,-9
19165,0,0,14,0,-14
19166,0,0,4,0,-4
19167,0,0,14,0,-14
19168,1,0,38,0,-38
19169,0,0,40,0,-40
19170,1,1,1518,1276,-242
19171,1,1,690,1355,665
19172,0,0,7,0,-7
19173,1,1,912,1202,290
19174,1,1,650,1313,663
19175,0,0,60,0,-60
19176,0,0,52,0,-52
19177,1,1,301,1317,1016
19178,0,0,22,0,-22
19179,1,0,103,0,-103
19180,0,0,13,0,-13
19181,1,0,215,0,-215
19182,0,0,155,0,-155
19183,1,1,1092,1508,416
19184,1,1,1025,1331,306
19185,0,0,32,0,-32
19186,0,0,60,0,-60
19187,1,1,1081,1548,467
19188,1,1,230,2310,2080
19189,1,1,767,2569,1802
19190,0,0,33,0,-33
19191,1,0,99,0,-99
19192,1,0,70,0,-70
19193,1,0,149,0,-149
19194,0,0,14,0,-14
19195,0,0,61,0,-61
19196,1,1,1581,1316,-265
19197,1,0,97,0,-97
19198,1,0,61,0,-61
19199,0,0,18,0,-18
19200,1,0,109,0,-109
19201,0,0,19,0,-19
19202,0,0,180,0,-180
19203,1,1,399,1541,1142
19204,1,0,29,0,-29
19205,1,1,90,1426,1336
19206,1,1,29,2793,2764
19207,1,0,18,0,-18
19208,1,1,645,1450,805
19209,1,1,40,1217,1177
19210,0,0,17,0,-17
19211,1,0,135,0,-135
19212,1,0,81,0,-81
19213,1,1,1402,1497,95
19214,0,0,24,0,-24
19215,1,0,107,0,-107
19216,1,0,8,0,-8
19217,1,0,26,0,-26
19218,0,0,0,0,0
19219,0,0,2,0,-2
19220,0,0,91,0,-91
19221,0,0,62,0,-62
19222,0,0,57,0,-57
19223,1,0,26,0,-26
19224,0,0,57,0,-57
19225,1,0,113,0,-113
19226,1,0,2,0,-2
19227,0,0,0,0,0
19228,1,0,181,0,-181
19229,1,1,252,1394,1142
19230,1,0,23,0,-23
19231,0,0,10,0,-10
19232,1,0,22,0,-22
19233,1,0,77,0,-77
19234,0,0,103,0,-103
19235,0,0,98,0,-98
19236,1,0,8,0,-8
19237,0,0,12,0,-12
19238,1,0,3,0,-3
19239,1,0,102,0,-102
19240,1,1,152,1202,1050
19241,1,0,45,0,-45
19242,1,1,260,1424,1164
19243,0,0,0,0,0
19244,1,1,157,2000,1843
19245,1,0,45,0,-45
19246,1,0,70,0,-70
19247,1,1,388,1792,1404
19248,0,0,33,0,-33
19249,1,0,3,0,-3
19250,0,0,3,0,-3
19251,1,0,114,0,-114
19252,1,1,599,1251,652
19253,1,1,171,2390,2219
19254,0,0,17,0,-17
19255,0,0,26,0,-26
19256,0,0,42,0,-42
19257,0,0,26,0,-26
19258,1,0,34,0,-34
19259,0,0,8,0,-8
19260,1,1,550,1325,775
19261,1,1,1199,1247,48
19262,1,1,513,1481,968
19263,0,0,84,0,-84
19264,1,1,740,1372,632
19265,0,0,138,0,-138
19266,1,0,45,0,-45
19267,1,0,59,0,-59
19268,1,1,379,2243,1864
19269,1,1,271,1768,1497
19270,0,0,17,0,-17
19271,1,0,41,0,-41
19272,0,0,32,0,-32
19273,1,1,144,1368,1224
19274,1,1,746,1695,949
19275,1,0,46,0,-46
19276,0,0,2,0,-2
19277,0,0,1,0,-1
19278,1,1,69,1218,1149
19279,1,1,733,1268,535
19280,1,1,846,1265,419
19281,1,1,118,1263,1145
19282,0,0,88,0,-88
19283,1,0,71,0,-71
19284,0,0,80,0,-80
19285,1,1,257,1231,974
19286,0,0,53,0,-53
19287,1,0,46,0,-46
19288,0,0,123,0,-123
19289,0,0,23,0,-23
19290,1,0,16,0,-16
19291,0,0,29,0,-29
19292,1,1,492,1344,852
19293,1,0,86,0,-86
19294,1,1,1339,1611,272
19295,1,1,94,1220,1126
19296,0,0,18,0,-18
19297,1,1,401,1379,978
19298,1,1,207,3433,3226
19299,1,0,134,0,-134
19300,1,1,214,1246,1032
19301,1,1,344,1210,866
19302,1,1,469,1842,1373
19303,0,0,148,0,-148
19304,0,0,12,0,-12
19305,1,0,0,0,0
19306,1,0,10,0,-10
19307,1,1,64,1652,1588
19308,1,1,144,1234,1090
19309,1,0,71,0,-71
19310,0,0,219,0,-219
19311,1,1,944,1240,296
19312,1,1,195,1282,1087
19313,1,0,42,0,-42
19314,1,1,273,1343,1070
19315,1,0,44,0,-44
19316,0,0,5,0,-5
19317,1,1,368,1413,1045
19318,1,0,13,0,-13
19319,1,1,1607,1376,-231
19320,0,0,11,0,-11
19321,0,0,44,0,-44
19322,0,0,11,0,-11
19323,0,0,99,0,-99
19324,1,0,369,0,-369
19325,1,0,7,0,-7
19326,1,1,1172,1226,54
19327,0,0,23,0,-23
19328,0,0,177,0,-177
19329,1,0,6,0,-6
19330,1,1,276,1503,1227
19331,1,1,310,1217,907
19332,1,1,205,1487,1282
19333,0,0,99,0,-99
19334,0,0,24,0,-24
19335,0,0,29,0,-29
19336,1,1,162,1206,1044
19337,0,0,95,0,-95
19338,1,0,21,0,-21
19339,0,0,13,0,-13
19340,1,0,130,0,-130
19341,0,0,70,0,-70
19342,0,0,10,0,-10
19343,1,0,6,0,-6
19344,1,1,1092,2313,1221
19345,1,1,335,1533,1198
19346,0,0,13,0,-13
19347,0,0,10,0,-10
19348,0,0,7,0,-7
19349,0,0,76,0,-76
19350,0,0,76,0,-76
19351,1,1,144,1350,1206
19352,1,1,725,1518,793
19353,1,1,327,2141,1814
19354,1,1,221,1404,1183
19355,1,0,18,0,-18
19356,0,0,43,0,-43
19357,1,0,55,0,-55
19358,1,0,49,0,-49
19359,1,0,99,0,-99
19360,1,1,573,1366,793
19361,0,0,1,0,-1
19362,0,0,70,0,-70
19363,0,0,78,0,-78
19364,0,0,16,0,-16
19365,1,0,5,0,-5
19366,0,0,26,0,-26
19367,1,1,166,1406,1240
19368,1,1,196,1219,1023
19369,1,0,73,0,-73
19370,1,0,76,0,-76
19371,1,1,314,1293,979
19372,1,0,68,0,-68
19373,1,0,3,0,-3
19374,1,0,11,0,-11
19375,0,0,24,0,-24
19376,1,0,110,0,-110
19377,1,1,605,1781,1176
19378,0,0,43,0,-43
19379,1,1,261,2294,2033
19380,1,0,49,0,-49
19381,0,0,108,0,-108
19382,1,0,88,0,-88
19383,1,1,929,1829,900
19384,0,0,11,0,-11
19385,0,0,22,0,-22
19386,1,0,0,0,0
19387,1,1,246,1272,1026
19388,0,0,36,0,-36
19389,1,1,732,2708,1976
19390,1,1,2051,1246,-805
19391,0,0,40,0,-40
19392,0,0,72,0,-72
19393,1,0,40,0,-40
19394,1,0,15,0,-15
19395,0,0,60,0,-60
19396,1,0,44,0,-44
19397,1,0,40,0,-40
19398,1,0,19,0,-19
19399,1,0,102,0,-102
19400,1,0,44,0,-44
19401,1,1,602,1258,656
19402,0,0,15,0,-15
19403,1,0,64,0,-64
19404,1,1,641,1610,969
19405,1,1,113,3199,3086
19406,0,0,2,0,-2
19407,0,0,57,0,-57
19408,1,1,123,1363,1240
19409,1,1,318,1700,1382
19410,0,0,21,0,-21
19411,0,0,35,0,-35
19412,1,0,0,0,0
19413,0,0,120,0,-120
19414,1,0,100,0,-100
19415,1,1,518,1217,699
19416,0,0,86,0,-86
19417,1,0,47,0,-47
19418,0,0,58,0,-58
19419,0,0,6,0,-6
19420,0,0,62,0,-62
19421,0,0,21,0,-21
19422,1,0,82,0,-82
19423,1,1,368,2183,1815
19424,0,0,2,0,-2
19425,0,0,210,0,-210
19426,1,0,28,0,-28
19427,0,0,24,0,-24
19428,1,1,919,1586,667
19429,1,0,96,0,-96
19430,1,1,148,1579,1431
19431,0,0,105,0,-105
19432,0,0,48,0,-48
19433,1,0,5,0,-5
19434,1,1,2133,1637,-496
19435,0,0,158,0,-158
19436,1,1,1181,1362,181
19437,0,0,62,0,-62
19438,1,0,5,0,-5
19439,1,1,329,1301,972
19440,1,1,283,1602,1319
19441,0,0,8,0,-8
19442,1,1,950,1716,766
19443,0,0,60,0,-60
19444,1,0,37,0,-37
19445,0,0,210,0,-210
19446,1,1,313,1395,1082
19447,1,0,31,0,-31
19448,1,1,37,1413,1376
19449,1,1,706,1610,904
19450,1,0,10,0,-10
19451,0,0,11,0,-11
19452,1,0,11,0,-11
19453,0,0,11,0,-11
19454,1,1,247,1507,1260
19455,1,0,9,0,-9
19456,1,0,2,0,-2
19457,1,0,22,0,-22
19458,1,1,244,1744,1500
19459,1,1,1389,2143,754
19460,1,0,142,0,-142
19461,0,0,139,0,-139
19462,1,0,26,0,-26
19463,1,0,22,0,-22
19464,1,1,253,2260,2007
19465,0,0,33,0,-33
19466,1,0,54,0,-54
19467,1,0,50,0,-50
19468,0,0,11,0,-11
19469,1,1,652,2118,1466
19470,1,0,20,0,-20
19471,1,1,321,1333,1012
19472,1,0,72,0,-72
19473,1,0,44,0,-44
19474,1,1,267,1307,1040
19475,1,0,123,0,-123
19476,1,1,840,1204,364
19477,0,0,54,0,-54
19478,1,0,147,0,-147
19479,1,1,278,1241,963
19480,0,0,65,0,-65
19481,1,0,26,0,-26
19482,1,0,88,0,-88
19483,1,0,141,0,-141
19484,0,0,32,0,-32
19485,0,0,96,0,-96
19486,0,0,67,0,-67
19487,1,0,40,0,-40
19488,1,0,25,0,-25
19489,1,0,5,0,-5
19490,1,1,176,1560,1384
19491,1,1,226,1327,1101
19492,1,0,114,0,-114
19493,0,0,1,0,-1
19494,0,0,96,0,-96
19495,1,0,21,0,-21
19496,1,0,35,0,-35
19497,1,1,186,1299,1113
19498,0,0,252,0,-252
19499,1,0,70,0,-70
19500,1,1,2280,1362,-918
19501,1,0,46,0,-46
19502,0,0,62,0,-62
19503,1,0,118,0,-118
19504,0,0,3,0,-3
19505,1,1,1028,1223,195
19506,1,1,287,1262,975
19507,0,0,34,0,-34
19508,0,0,113,0,-113
19509,1,1,228,3637,3409
19510,0,0,52,0,-52
19511,1,0,11,0,-11
19512,1,0,108,0,-108
19513,0,0,149,0,-149
19514,0,0,58,0,-58
19515,1,1,217,1311,1094
19516,1,0,127,0,-127
19517,1,0,194,0,-194
19518,1,0,94,0,-94
19519,1,0,22,0,-22
19520,1,0,3,0,-3
19521,1,1,357,1240,883
19522,0,0,17,0,-17
19523,1,0,5,0,-5
19524,0,0,30,0,-30
19525,0,0,30,0,-30
19526,1,1,197,1345,1148
19527,1,1,204,1269,1065
19528,1,1,801,2041,1240
19529,1,0,18,0,-18
19530,1,0,11,0,-11
19531,0,0,25,0,-25
19532,0,0,6,0,-6
19533,0,0,66,0,-66
19534,1,1,578,1847,1269
19535,0,0,145,0,-145
19536,1,1,1133,1567,434
19537,1,0,28,0,-28
19538,0,0,6,0,-6
19539,1,1,2635,1985,-650
19540,0,0,64,0,-64
19541,0,0,45,0,-45
19542,1,0,33,0,-33
19543,1,0,66,0,-66
19544,0,0,8,0,-8
19545,0,0,16,0,-16
19546,0,0,13,0,-13
19547,1,0,69,0,-69
19548,1,0,15,0,-15
19549,1,0,29,0,-29
19550,0,0,44,0,-44
19551,0,0,59,0,-59
19552,1,0,3,0,-3
19553,1,0,11,0,-11
19554,1,0,0,0,0
19555,0,0,5,0,-5
19556,1,0,148,0,-148
19557,1,0,18,0,-18
19558,1,1,83,1303,1220
19559,1,1,177,1678,1501
19560,1,0,21,0,-21
19561,1,1,1399,1419,20
19562,0,0,8,0,-8
19563,1,0,54,0,-54
19564,1,0,24,0,-24
19565,1,1,490,1347,857
19566,1,0,85,0,-85
19567,0,0,19,0,-19
19568,1,0,29,0,-29
19569,1,0,2,0,-2
19570,1,1,139,1400,1261
19571,0,0,16,0,-16
19572,1,0,21,0,-21
19573,1,1,880,1781,901
19574,1,1,2266,1301,-965
19575,1,0,59,0,-59
19576,1,1,114,1224,1110
19577,0,0,10,0,-10
19578,1,1,535,1678,1143
19579,0,0,38,0,-38
19580,1,1,169,1253,1084
19581,0,0,6,0,-6
19582,1,0,11,0,-11
19583,1,1,510,1377,867
19584,1,0,27,0,-27
19585,1,1,133,1648,1515
19586,1,1,640,1239,599
19587,0,0,57,0,-57
19588,1,1,761,1271,510
19589,1,0,16,0,-16
19590,0,0,20,0,-20
19591,0,0,51,0,-51
19592,0,0,65,0,-65
19593,1,1,358,1260,902
19594,1,1,22,3224,3202
19595,1,0,56,0,-56
19596,1,0,1,0,-1
19597,1,1,421,1464,1043
19598,0,0,51,0,-51
19599,0,0,98,0,-98
19600,1,0,149,0,-149
19601,1,0,12,0,-12
19602,1,1,132,1251,1119
19603,1,0,67,0,-67
19604,1,0,14,0,-14
19605,0,0,43,0,-43
19606,1,0,47,0,-47
19607,1,0,7,0,-7
19608,1,1,2764,1289,-1475
19609,0,0,20,0,-20
19610,0,0,10,0,-10
19611,1,0,29,0,-29
19612,0,0,8,0,-8
19613,1,0,18,0,-18
19614,1,0,35,0,-35
19615,1,1,710,1263,553
19616,1,1,974,2179,1205
19617,1,0,17,0,-17
19618,0,0,43,0,-43
19619,0,0,139,0,-139
19620,0,0,56,0,-56
19621,1,0,15,0,-15
19622,0,0,135,0,-135
19623,0,0,45,0,-45
19624,1,0,3,0,-3
19625,1,1,483,1342,859
19626,0,0,9,0,-9
19627,1,0,24,0,-24
19628,0,0,26,0,-26
19629,0,0,19,0,-19
19630,1,0,218,0,-218
19631,0,0,42,0,-42
19632,1,0,31,0,-31
19633,0,0,12,0,-12
19634,0,0,2,0,-2
19635,1,0,101,0,-101
19636,0,0,14,0,-14
19637,0,0,164,0,-164
19638,1,0,16,0,-16
19639,1,0,79,0,-79
19640,1,1,452,1217,765
19641,0,0,55,0,-55
19642,1,1,208,1440,1232
19643,0,0,65,0,-65
19644,0,0,40,0,-40
19645,1,1,947,1213,266
19646,1,0,14,0,-14
19647,1,0,36,0,-36
19648,0,0,73,0,-73
19649,0,0,57,0,-57
19650,1,0,236,0,-236
19651,0,0,97,0,-97
19652,1,1,305,1685,1380
19653,1,0,60,0,-60
19654,0,0,9,0,-9
19655,0,0,0,0,0
19656,0,0,12,0,-12
19657,1,1,896,1208,312
19658,0,0,15,0,-15
19659,1,1,676,1220,544
19660,0,0,25,0,-25
19661,0,0,71,0,-71
19662,0,0,66,0,-66
19663,0,0,71,0,-71
19664,0,0,103,0,-103
19665,0,0,10,0,-10
19666,0,0,14,0,-14
19667,0,0,4,0,-4
19668,1,1,23,1224,1201
19669,0,0,75,0,-75
19670,1,1,202,2449,2247
19671,0,0,121,0,-121
19672,1,0,49,0,-49
19673,1,1,82,1322,1240
19674,0,0,24,0,-24
19675,1,0,58,0,-58
19676,1,0,113,0,-113
19677,1,0,83,0,-83
19678,0,0,128,0,-128
19679,1,0,10,0,-10
19680,0,0,136,0,-136
19681,1,1,2143,1403,-740
19682,0,0,33,0,-33
19683,1,1,1192,1517,325
19684,0,0,24,0,-24
19685,1,0,2,0,-2
19686,0,0,103,0,-103
19687,1,0,82,0,-82
19688,1,0,7,0,-7
19689,1,0,57,0,-57
19690,1,0,0,0,0
19691,1,0,108,0,-108
19692,1,1,3192,2213,-979
19693,1,0,7,0,-7
19694,1,1,369,2355,1986
19695,1,0,33,0,-33
19696,1,1,364,1855,1491
19697,1,0,66,0,-66
19698,0,0,26,0,-26
19699,1,1,274,1397,1123
19700,0,0,27,0,-27
19701,1,1,72,1654,1582
19702,1,0,330,0,-330
19703,1,1,102,1526,1424
19704,1,0,6,0,-6
19705,0,0,12,0,-12
19706,0,0,93,0,-93
19707,1,0,0,0,0
19708,1,0,54,0,-54
19709,1,0,38,0,-38
19710,0,0,18,0,-18
19711,0,0,139,0,-139
19712,0,0,9,0,-9
19713,1,1,341,2431,2090
19714,0,0,14,0,-14
19715,1,1,484,2414,1930
19716,0,0,22,0,-22
19717,0,0,26,0,-26
19718,0,0,43,0,-43
19719,0,0,40,0,-40
19720,0,0,117,0,-117
19721,1,1,568,1714,1146
19722,1,0,227,0,-227
19723,1,0,45,0,-45
19724,1,0,36,0,-36
19725,1,0,6,0,-6
19726,1,1,1746,1382,-364
19727,0,0,11,0,-11
19728,0,0,1,0,-1
19729,1,0,107,0,-107
19730,0,0,113,0,-113
19731,1,0,132,0,-132
19732,1,0,28,0,-28
19733,1,0,73,0,-73
19734,0,0,4,0,-4
19735,1,0,0,0,0
19736,1,0,59,0,-59
19737,0,0,34,0,-34
19738,0,0,10,0,-10
19739,1,1,374,1301,927
19740,1,0,52,0,-52
19741,1,1,984,1223,239
19742,0,0,54,0,-54
19743,1,0,35,0,-35
19744,0,0,21,0,-21
19745,1,1,623,1315,692
19746,0,0,2,0,-2
19747,1,0,74,0,-74
19748,0,0,5,0,-5
19749,0,0,2,0,-2
19750,1,1,478,1512,1034
19751,1,0,157,0,-157
19752,1,1,1093,1302,209
19753,1,0,40,0,-40
19754,0,0,39,0,-39
19755,1,0,10,0,-10
19756,1,1,335,1281,946
19757,1,1,864,1637,773
19758,0,0,144,0,-144
19759,1,0,82,0,-82
19760,0,0,3,0,-3
19761,0,0,94,0,-94
19762,1,0,129,0,-129
19763,0,0,217,0,-217
19764,1,0,145,0,-145
19765,0,0,42,0,-42
19766,0,0,25,0,-25
19767,1,1,880,2509,1629
19768,1,0,79,0,-79
19769,0,0,11,0,-11
19770,1,0,128,0,-128
19771,1,1,1084,2583,1499
19772,1,1,28,1485,1457
19773,1,0,27,0,-27
19774,1,1,71,1269,1198
19775,1,0,4,0,-4
19776,0,0,76,0,-76
19777,1,0,94,0,-94
19778,0,0,94,0,-94
19779,1,0,31,0,-31
19780,0,0,4,0,-4
19781,1,1,884,1346,462
19782,1,1,49,1654,1605
19783,1,0,37,0,-37
19784,1,1,377,1301,924
19785,0,0,21,0,-21
19786,1,0,71,0,-71
19787,1,1,852,1955,1103
19788,1,0,86,0,-86
19789,1,0,30,0,-30
19790,1,1,397,3609,3212
19791,1,0,13,0,-13
19792,1,0,42,0,-42
19793,1,1,637,1478,841
19794,1,0,1,0,-1
19795,1,1,423,1751,1328
19796,1,1,455,1575,1120
19797,1,0,34,0,-34
19798,0,0,25,0,-25
19799,0,0,25,0,-25
19800,1,0,55,0,-55
19801,1,1,272,1677,1405
19802,0,0,4,0,-4
19803,1,1,131,1821,1690
19804,0,0,36,0,-36
19805,0,0,73,0,-73
19806,0,0,1,0,-1
19807,0,0,13,0,-13
19808,1,0,148,0,-148
19809,1,0,19,0,-19
19810,0,0,198,0,-198
19811,1,0,80,0,-80
19812,0,0,103,0,-103
19813,1,1,385,1237,852
19814,0,0,7,0,-7
19815,0,0,123,0,-123
19816,0,0,40,0,-40
19817,0,0,71,0,-71
19818,0,0,107,0,-107
19819,0,0,46,0,-46
19820,0,0,250,0,-250
19821,0,0,60,0,-60
19822,0,0,44,0,-44
19823,1,1,302,1550,1248
19824,1,0,53,0,-53
19825,0,0,140,0,-140
19826,1,0,69,0,-69
19827,1,0,53,0,-53
19828,0,0,32,0,-32
19829,0,0,82,0,-82
19830,0,0,3,0,-3
19831,1,0,9,0,-9
19832,0,0,22,0,-22
19833,1,1,424,1701,1277
19834,1,0,35,0,-35
19835,1,0,2,0,-2
19836,1,0,0,0,0
19837,0,0,2,0,-2
19838,1,1,112,1356,1244
19839,0,0,13,0,-13
19840,0,0,3,0,-3
19841,1,1,257,2508,2251
19842,0,0,24,0,-24
19843,1,0,61,0,-61
19844,0,0,95,0,-95
19845,1,0,65,0,-65
19846,1,0,8,0,-8
19847,0,0,32,0,-32
19848,1,0,11,0,-11
19849,1,1,147,1251,1104
19850,1,1,640,1535,895
19851,0,0,46,0,-46
19852,1,0,18,0,-18
19853,0,0,18,0,-18
19854,1,1,398,1380,982
19855,1,1,428,1232,804
19856,1,0,30,0,-30
19857,1,0,1,0,-1
19858,0,0,16,0,-16
19859,1,0,32,0,-32
19860,0,0,65,0,-65
19861,0,0,13,0,-13
19862,0,0,2,0,-2
19863,0,0,12,0,-12
19864,1,0,9,0,-9
19865,1,1,414,1315,901
19866,1,0,5,0,-5
19867,0,0,86,0,-86
19868,1,0,4,0,-4
19869,1,1,100,1642,1542
19870,1,0,9,0,-9
19871,1,1,267,1254,987
19872,1,0,205,0,-205
19873,0,0,31,0,-31
19874,1,1,247,1507,1260
19875,0,0,17,0,-17
19876,0,0,19,0,-19
19877,1,0,53,0,-53
19878,0,0,60,0,-60
19879,1,0,102,0,-102
19880,1,0,7,0,-7
19881,1,1,804,1334,530
19882,1,1,109,1207,1098
19883,0,0,8,0,-8
19884,0,0,63,0,-63
19885,1,0,52,0,-52
19886,1,0,11,0,-11
19887,1,0,10,0,-10
19888,1,1,336,1311,975
19889,0,0,31,0,-31
19890,0,0,16,0,-16
19891,1,0,118,0,-118
19892,1,0,42,0,-42
19893,1,1,367,1360,993
19894,1,1,109,1494,1385
19895,0,0,1,0,-1
19896,1,1,219,1810,1591
19897,1,1,81,1313,1232
19898,0,0,97,0,-97
19899,0,0,4,0,-4
19900,0,0,42,0,-42
19901,1,1,344,1250,906
19902,1,1,994,3244,2250
19903,0,0,21,0,-21
19904,0,0,90,0,-90
19905,1,0,60,0,-60
19906,1,1,72,1308,1236
19907,1,1,418,1260,842
19908,0,0,61,0,-61
19909,1,1,1697,1250,-447
19910,1,0,6,0,-6
19911,1,1,196,1323,1127
19912,1,0,112,0,-112
19913,1,0,61,0,-61
19914,1,1,1323,1489,166
19915,0,0,122,0,-122
19916,0,0,14,0,-14
19917,1,0,40,0,-40
19918,1,0,69,0,-69
19919,0,0,17,0,-17
19920,1,1,658,1452,794
19921,0,0,2,0,-2
19922,1,1,281,1327,1046
19923,1,1,953,1510,557
19924,1,0,11,0,-11
19925,1,0,40,0,-40
19926,0,0,32,0,-32
19927,0,0,3,0,-3
19928,0,0,184,0,-184
19929,0,0,63,0,-63
19930,0,0,10,0,-10
19931,0,0,48,0,-48
19932,0,0,129,0,-129
19933,1,0,15,0,-15
19934,0,0,8,0,-8
19935,1,1,826,1263,437
19936,1,1,9,1459,1450
19937,1,1,180,1607,1427
19938,1,0,16,0,-16
19939,0,0,9,0,-9
19940,1,1,749,2499,1750
19941,0,0,26,0,-26
19942,0,0,24,0,-24
19943,0,0,171,0,-171
19944,1,1,1553,1240,-313
19945,0,0,1,0,-1
19946,0,0,3,0,-3
19947,1,1,896,1376,480
19948,0,0,101,0,-101
19949,0,0,38,0,-38
19950,1,1,827,1363,536
19951,0,0,29,0,-29
19952,0,0,9,0,-9
19953,0,0,24,0,-24
19954,0,0,3,0,-3
19955,1,0,21,0,-21
19956,0,0,92,0,-92
19957,1,0,259,0,-259
19958,1,0,14,0,-14
19959,1,1,580,1637,1057
19960,1,1,2024,1280,-744
19961,1,0,57,0,-57
19962,0,0,72,0,-72
19963,1,0,19,0,-19
19964,0,0,246,0,-246
19965,0,0,79,0,-79
19966,0,0,16,0,-16
19967,1,0,12,0,-12
19968,1,0,80,0,-80
19969,0,0,12,0,-12
19970,1,0,15,0,-15
19971,1,1,317,1410,1093
19972,1,1,416,1246,830
19973,0,0,54,0,-54
19974,1,0,49,0,-49
19975,0,0,17,0,-17
19976,1,1,125,1369,1244
19977,1,1,477,1206,729
19978,1,1,307,1742,1435
19979,0,0,18,0,-18
19980,0,0,46,0,-46
19981,1,1,855,1403,548
19982,1,1,1613,1214,-399
19983,1,1,119,1264,1145
19984,1,0,13,0,-13
19985,0,0,26,0,-26
19986,1,0,8,0,-8
19987,0,0,8,0,-8
19988,1,0,16,0,-16
19989,1,1,115,1532,1417
19990,0,0,17,0,-17
19991,0,0,209,0,-209
19992,0,0,59,0,-59
19993,0,0,116,0,-116
19994,0,0,39,0,-39
19995,0,0,61,0,-61
19996,0,0,151,0,-151
19997,1,0,26,0,-26
19998,0,0,10,0,-10
19999,0,0,65,0,-65
20000,1,0,31,0,-31
20001,0,0,46,0,-46
20002,1,0,29,0,-29
20003,1,0,76,0,-76
20004,1,0,156,0,-156
20005,1,1,531,1379,848
20006,1,0,38,0,-38
20007,1,0,7,0,-7
20008,1,1,270,1277,1007
20009,1,1,511,1734,1223
20010,0,0,0,0,0
20011,0,0,35,0,-35
20012,0,0,17,0,-17
20013,1,0,54,0,-54
20014,1,1,781,1395,614
20015,1,0,0,0,0
20016,1,0,146,0,-146
20017,1,1,2058,1236,-822
20018,1,0,27,0,-27
20019,0,0,45,0,-45
20020,0,0,1,0,-1
20021,0,0,27,0,-27
20022,0,0,5,0,-5
20023,0,0,92,0,-92
20024,1,1,517,1290,773
20025,1,0,14,0,-14
20026,0,0,17,0,-17
20027,0,0,54,0,-54
20028,1,0,27,0,-27
20029,0,0,167,0,-167
20030,1,1,294,1434,1140
20031,1,1,285,1204,919
20032,0,0,34,0,-34
20033,0,0,19,0,-19
20034,1,1,287,1381,1094
20035,1,1,747,1315,568
20036,0,0,111,0,-111
20037,0,0,28,0,-28
20038,1,1,119,1319,1200
20039,0,0,179,0,-179
20040,0,0,31,0,-31
20041,0,0,89,0,-89
20042,0,0,81,0,-81
20043,0,0,9,0,-9
20044,1,0,17,0,-17
20045,1,1,1165,1351,186
20046,1,0,147,0,-147
20047,1,1,725,1505,780
20048,1,0,3,0,-3
20049,0,0,35,0,-35
20050,1,0,29,0,-29
20051,0,0,160,0,-160
20052,1,0,17,0,-17
20053,0,0,26,0,-26
20054,1,0,40,0,-40
20055,0,0,35,0,-35
20056,0,0,21,0,-21
20057,0,0,117,0,-117
20058,0,0,0,0,0
20059,1,1,97,1399,1302
20060,0,0,11,0,-11
20061,0,0,90,0,-90
20062,1,1,495,1512,1017
20063,0,0,5,0,-5
20064,1,1,669,1521,852
20065,1,1,1037,1502,465
20066,1,0,26,0,-26
20067,1,1,115,2266,2151
20068,1,1,291,1808,1517
20069,0,0,36,0,-36
20070,1,1,119,1437,1318
20071,0,0,44,0,-44
20072,0,0,3,0,-3
20073,1,0,168,0,-168
20074,0,0,53,0,-53
20075,1,1,589,1459,870
20076,1,1,1423,1447,24
20077,1,1,424,1909,1485
20078,1,0,101,0,-101
20079,1,0,15,0,-15
20080,1,0,40,0,-40
20081,1,1,286,1204,918
20082,1,0,50,0,-50
20083,0,0,14,0,-14
20084,1,0,67,0,-67
20085,0,0,162,0,-162
20086,0,0,5,0,-5
20087,1,1,540,1255,715
20088,1,0,10,0,-10
20089,1,1,400,1579,1179
20090,1,0,76,0,-76
20091,0,0,20,0,-20
20092,1,0,15,0,-15
20093,1,0,83,0,-83
20094,1,1,914,1566,652
20095,1,1,28,1492,1464
20096,0,0,48,0,-48
20097,1,0,4,0,-4
20098,1,0,22,0,-22
20099,1,0,2,0,-2
20100,1,1,236,1803,1567
20101,0,0,20,0,-20
20102,0,0,7,0,-7
20103,1,0,97,0,-97
20104,1,1,631,1298,667
20105,0,0,6,0,-6
20106,1,1,184,1242,1058
20107,1,1,46,1752,1706
20108,1,1,549,1229,680
20109,0,0,18,0,-18
20110,1,0,18,0,-18
20111,1,0,10,0,-10
20112,1,0,72,0,-72
20113,1,0,22,0,-22
20114,1,0,107,0,-107
20115,1,1,403,1682,1279
20116,0,0,54,0,-54
20117,0,0,78,0,-78
20118,0,0,58,0,-58
20119,1,0,32,0,-32
20120,0,0,59,0,-59
20121,0,0,59,0,-59
20122,1,1,59,1614,1555
20123,1,0,39,0,-39
20124,0,0,64,0,-64
20125,1,1,224,2019,1795
20126,1,0,19,0,-19
20127,0,0,97,0,-97
20128,1,1,664,1322,658
20129,1,0,5,0,-5
20130,1,1,326,3617,3291
20131,1,1,158,1353,1195
20132,1,0,9,0,-9
20133,1,0,32,0,-32
20134,1,0,66,0,-66
20135,0,0,74,0,-74
20136,0,0,49,0,-49
20137,1,0,76,0,-76
20138,0,0,11,0,-11
20139,1,0,13,0,-13
20140,0,0,71,0,-71
20141,0,0,15,0,-15
20142,1,0,94,0,-94
20143,1,0,100,0,-100
20144,1,1,93,1744,1651
20145,1,0,4,0,-4
20146,1,0,45,0,-45
20147,1,1,521,1204,683
20148,0,0,39,0,-39
20149,1,1,179,1393,1214
20150,0,0,11,0,-11
20151,1,0,97,0,-97
20152,1,1,933,1802,869
20153,0,0,26,0,-26
20154,1,0,38,0,-38
20155,1,0,65,0,-65
20156,1,0,30,0,-30
20157,0,0,13,0,-13
20158,1,0,5,0,-5
20159,0,0,83,0,-83
20160,1,1,579,1765,1186
20161,1,0,6,0,-6
20162,1,0,124,0,-124
20163,1,1,117,1456,1339
20164,0,0,3,0,-3
20165,1,1,501,3081,2580
20166,0,0,14,0,-14
20167,1,1,88,1331,1243
20168,1,0,13,0,-13
20169,0,0,62,0,-62
20170,0,0,55,0,-55
20171,0,0,53,0,-53
20172,0,0,166,0,-166
20173,1,0,11,0,-11
20174,0,0,90,0,-90
20175,0,0,22,0,-22
20176,1,0,39,0,-39
20177,0,0,30,0,-30
20178,1,1,56,1740,1684
20179,0,0,63,0,-63
20180,0,0,5,0,-5
20181,1,0,25,0,-25
20182,1,0,117,0,-117
20183,1,0,11,0,-11
20184,1,0,61,0,-61
20185,0,0,44,0,-44
20186,1,1,188,1313,1125
20187,1,1,37,1558,1521
20188,1,0,166,0,-166
20189,1,0,21,0,-21
20190,0,0,207,0,-207
20191,1,0,71,0,-71
20192,1,0,35,0,-35
20193,1,0,18,0,-18
20194,1,1,979,2562,1583
20195,0,0,35,0,-35
20196,1,0,25,0,-25
20197,0,0,76,0,-76
20198,0,0,1,0,-1
20199,1,0,33,0,-33
20200,1,0,1,0,-1
20201,0,0,30,0,-30
20202,0,0,0,0,0
20203,0,0,93,0,-93
20204,0,0,19,0,-19
20205,0,0,31,0,-31
20206,1,1,418,1341,923
20207,1,1,57,1673,1616
20208,1,0,42,0,-42
20209,0,0,28,0,-28
20210,1,0,137,0,-137
20211,1,0,96,0,-96
20212,1,0,117,0,-117
20213,1,1,396,1216,820
20214,0,0,6,0,-6
20215,1,1,564,1672,1108
20216,0,0,14,0,-14
20217,1,1,542,1277,735
20218,0,0,21,0,-21
20219,0,0,5,0,-5
20220,1,1,327,1224,897
20221,1,1,370,1257,887
20222,1,0,29,0,-29
20223,0,0,62,0,-62
20224,0,0,0,0,0
20225,0,0,6,0,-6
20226,1,0,3,0,-3
20227,1,1,726,2491,1765
20228,1,0,1,0,-1
20229,0,0,66,0,-66
20230,1,1,339,1460,1121
20231,1,0,24,0,-24
20232,0,0,116,0,-116
20233,1,1,148,1222,1074
20234,0,0,82,0,-82
20235,0,0,2,0,-2
20236,1,0,92,0,-92
20237,1,0,22,0,-22
20238,1,0,91,0,-91
20239,0,0,71,0,-71
20240,0,0,62,0,-62
20241,0,0,19,0,-19
20242,0,0,13,0,-13
20243,1,1,262,1492,1230
20244,1,1,306,1278,972
20245,0,0,77,0,-77
20246,1,0,24,0,-24
20247,1,1,444,1271,827
20248,1,1,401,2114,1713
20249,0,0,15,0,-15
20250,1,0,88,0,-88
20251,1,1,601,1345,744
20252,0,0,22,0,-22
20253,1,0,6,0,-6
20254,1,1,718,1433,715
20255,1,0,36,0,-36
20256,1,1,515,1797,1282
20257,1,1,260,1315,1055
20258,1,1,894,1365,471
20259,0,0,23,0,-23
20260,1,1,73,1431,1358
20261,1,0,60,0,-60
20262,1,1,886,1351,465
20263,0,0,62,0,-62
20264,0,0,172,0,-172
20265,0,0,42,0,-42
20266,1,0,15,0,-15
20267,0,0,138,0,-138
20268,0,0,181,0,-181
20269,1,1,32,1351,1319
20270,1,1,252,1241,989
20271,1,0,33,0,-33
20272,1,0,16,0,-16
20273,0,0,1,0,-1
20274,1,1,662,1494,832
20275,1,0,141,0,-141
20276,1,0,48,0,-48
20277,1,0,203,0,-203
20278,1,0,39,0,-39
20279,0,0,106,0,-106
20280,1,1,325,1219,894
20281,1,1,73,1242,1169
20282,1,0,86,0,-86
20283,0,0,12,0,-12
20284,0,0,10,0,-10
20285,0,0,50,0,-50
20286,1,0,23,0,-23
20287,0,0,25,0,-25
20288,0,0,36,0,-36
20289,1,1,303,1340,1037
20290,1,0,31,0,-31
20291,0,0,5,0,-5
20292,0,0,14,0,-14
20293,1,0,11,0,-11
20294,1,1,301,1434,1133
20295,0,0,151,0,-151
20296,1,1,776,1945,1169
20297,0,0,117,0,-117
20298,1,1,351,1220,869
20299,1,1,809,1377,568
20300,1,0,14,0,-14
20301,0,0,130,0,-130
20302,0,0,27,0,-27
20303,1,1,71,1209,1138
20304,1,1,92,1432,1340
20305,1,0,67,0,-67
20306,1,1,2680,1657,-1023
20307,1,1,608,1295,687
20308,0,0,8,0,-8
20309,1,1,92,1324,1232
20310,1,1,1383,4804,3421
20311,1,0,27,0,-27
20312,1,1,204,1667,1463
20313,1,1,944,1310,366
20314,1,0,65,0,-65
20315,1,0,215,0,-215
20316,1,1,377,2757,2380
20317,0,0,72,0,-72
20318,1,0,3,0,-3
20319,0,0,0,0,0
20320,1,0,88,0,-88
20321,0,0,42,0,-42
20322,1,0,13,0,-13
20323,1,1,713,1587,874
20324,0,0,1,0,-1
20325,1,0,63,0,-63
20326,1,0,2,0,-2
20327,0,0,70,0,-70
20328,1,1,147,1476,1329
20329,1,0,74,0,-74
20330,1,1,916,1234,318
20331,1,0,5,0,-5
20332,1,1,216,2108,1892
20333,0,0,31,0,-31
20334,1,0,29,0,-29
20335,1,1,472,1425,953
20336,0,0,61,0,-61
20337,0,0,26,0,-26
20338,1,0,34,0,-34
20339,1,1,484,1286,802
20340,1,1,947,1362,415
20341,1,1,174,1213,1039
20342,1,0,14,0,-14
20343,0,0,76,0,-76
20344,0,0,40,0,-40
20345,1,0,87,0,-87
20346,1,0,23,0,-23
20347,0,0,23,0,-23
20348,0,0,11,0,-11
20349,1,0,24,0,-24
20350,1,1,286,1321,1035
20351,1,1,46,1689,1643
20352,1,0,5,0,-5
20353,1,1,1240,1250,10
20354,0,0,2,0,-2
20355,1,0,30,0,-30
20356,0,0,98,0,-98
20357,1,1,487,1320,833
20358,1,0,35,0,-35
20359,0,0,80,0,-80
20360,1,1,252,1896,1644
20361,1,1,193,1280,1087
20362,1,0,19,0,-19
20363,0,0,26,0,-26
20364,0,0,16,0,-16
20365,0,0,32,0,-32
20366,1,1,26,1449,1423
20367,1,1,650,1312,662
20368,0,0,119,0,-119
20369,0,0,22,0,-22
20370,0,0,41,0,-41
20371,1,1,1304,2719,1415
20372,1,1,722,1376,654
20373,1,0,57,0,-57
20374,0,0,33,0,-33
20375,0,0,136,0,-136
20376,0,0,33,0,-33
20377,1,1,235,1282,1047
20378,1,1,433,1205,772
20379,1,0,6,0,-6
20380,1,0,215,0,-215
20381,0,0,2,0,-2
20382,1,0,114,0,-114
20383,1,1,239,2853,2614
20384,0,0,2,0,-2
20385,1,1,2144,3538,1394
20386,0,0,84,0,-84
20387,1,0,61,0,-61
20388,1,0,112,0,-112
20389,1,0,14,0,-14
20390,0,0,24,0,-24
20391,1,1,964,1332,368
20392,0,0,74,0,-74
20393,0,0,13,0,-13
20394,0,0,66,0,-66
20395,0,0,7,0,-7
20396,1,1,1069,2559,1490
20397,1,1,184,1531,1347
20398,1,0,5,0,-5
20399,0,0,41,0,-41
20400,1,0,14,0,-14
20401,0,0,6,0,-6
20402,1,0,9,0,-9
20403,1,0,1,0,-1
20404,1,1,341,1319,978
20405,1,0,44,0,-44
20406,1,0,26,0,-26
20407,1,1,59,1416,1357
20408,1,1,308,1300,992
20409,1,0,54,0,-54
20410,0,0,32,0,-32
20411,0,0,2,0,-2
20412,1,1,183,1234,1051
20413,1,0,3,0,-3
20414,0,0,88,0,-88
20415,1,1,1419,1380,-39
20416,1,1,584,1689,1105
20417,1,0,92,0,-92
20418,0,0,44,0,-44
20419,1,1,149,2640,2491
20420,1,0,91,0,-91
20421,1,1,95,2700,2605
20422,0,0,29,0,-29
20423,0,0,30,0,-30
20424,1,1,296,1391,1095
20425,1,0,39,0,-39
20426,0,0,142,0,-142
20427,1,0,4,0,-4
20428,1,0,22,0,-22
20429,0,0,33,0,-33
20430,1,0,47,0,-47
20431,1,1,525,1855,1330
20432,1,0,12,0,-12
20433,0,0,50,0,-50
20434,1,1,276,1236,960
20435,1,0,102,0,-102
20436,0,0,74,0,-74
20437,1,1,530,1379,849
20438,0,0,79,0,-79
20439,1,0,6,0,-6
20440,1,1,136,2737,2601
20441,1,1,63,1331,1268
20442,1,1,195,1796,1601
20443,0,0,17,0,-17
20444,1,0,5,0,-5
20445,1,1,442,1287,845
20446,1,1,337,1416,1079
20447,0,0,52,0,-52
20448,1,1,608,1406,798
20449,1,1,133,1743,1610
20450,1,0,96,0,-96
20451,0,0,2,0,-2
20452,1,0,2,0,-2
20453,0,0,85,0,-85
20454,1,0,86,0,-86
20455,0,0,0,0,0
20456,1,1,823,1210,387
20457,1,1,850,1203,353
20458,1,1,359,1354,995
20459,1,1,504,1522,1018
20460,1,1,911,1477,566
20461,0,0,46,0,-46
20462,1,0,24,0,-24
20463,1,0,3,0,-3
20464,1,0,7,0,-7
20465,1,1,55,2495,2440
20466,1,0,46,0,-46
20467,0,0,26,0,-26
20468,0,0,63,0,-63
20469,1,1,1074,1729,655
20470,1,0,112,0,-112
20471,0,0,53,0,-53
20472,1,0,377,0,-377
20473,1,1,575,1723,1148
20474,0,0,35,0,-35
20475,0,0,121,0,-121
20476,0,0,50,0,-50
20477,0,0,44,0,-44
20478,1,0,7,0,-7
20479,1,1,800,1219,419
20480,1,0,7,0,-7
20481,1,0,4,0,-4
20482,0,0,46,0,-46
20483,0,0,170,0,-170
20484,0,0,27,0,-27
20485,1,1,578,1376,798
20486,0,0,64,0,-64
20487,1,1,611,1209,598
20488,0,0,80,0,-80
20489,0,0,39,0,-39
20490,0,0,5,0,-5
20491,1,0,24,0,-24
20492,1,1,519,1380,861
20493,1,0,36,0,-36
20494,0,0,57,0,-57
20495,1,1,661,1488,827
20496,1,0,21,0,-21
20497,1,0,79,0,-79
20498,1,1,56,1241,1185
20499,1,1,943,1352,409
20500,1,1,355,1647,1292
20501,1,1,1003,1382,379
20502,0,0,31,0,-31
20503,1,0,7,0,-7
20504,0,0,9,0,-9
20505,1,1,276,1227,951
20506,0,0,122,0,-122
20507,1,0,55,0,-55
20508,1,1,294,1511,1217
20509,1,0,29,0,-29
20510,1,0,24,0,-24
20511,0,0,108,0,-108
20512,0,0,9,0,-9
20513,1,0,202,0,-202
20514,0,0,7,0,-7
20515,1,0,20,0,-20
20516,0,0,17,0,-17
20517,1,0,14,0,-14
20518,0,0,48,0,-48
20519,0,0,9,0,-9
20520,1,1,96,1817,1721
20521,1,1,588,1628,1040
20522,1,0,10,0,-10
20523,0,0,37,0,-37
20524,0,0,9,0,-9
20525,1,0,94,0,-94
20526,1,1,110,2077,1967
20527,0,0,5,0,-5
20528,1,0,133,0,-133
20529,0,0,19,0,-19
20530,1,1,1067,2722,1655
20531,0,0,118,0,-118
20532,0,0,0,0,0
20533,1,1,98,1252,1154
20534,1,0,39,0,-39
20535,1,1,568,1818,1250
20536,0,0,0,0,0
20537,1,0,11,0,-11
20538,1,1,192,1580,1388
20539,0,0,41,0,-41
20540,1,1,293,1651,1358
20541,0,0,49,0,-49
20542,1,1,349,1683,1334
20543,1,0,8,0,-8
20544,0,0,185,0,-185
20545,1,0,24,0,-24
20546,0,0,3,0,-3
20547,1,0,33,0,-33
20548,1,1,1068,3005,1937
20549,1,0,78,0,-78
20550,1,0,5,0,-5
20551,0,0,47,0,-47
20552,0,0,32,0,-32
20553,0,0,27,0,-27
20554,1,1,440,1691,1251
20555,0,0,24,0,-24
20556,1,0,69,0,-69
20557,1,0,58,0,-58
20558,1,0,16,0,-16
20559,1,0,30,0,-30
20560,1,0,42,0,-42
20561,1,1,353,1204,851
20562,0,0,16,0,-16
20563,0,0,22,0,-22
20564,1,0,203,0,-203
20565,1,1,1385,1308,-77
20566,1,0,10,0,-10
20567,1,1,422,1347,925
20568,1,1,953,1276,323
20569,1,0,95,0,-95
20570,0,0,265,0,-265
20571,1,0,39,0,-39
20572,0,0,37,0,-37
20573,0,0,98,0,-98
20574,1,1,14,1661,1647
20575,1,0,23,0,-23
20576,1,0,56,0,-56
20577,0,0,170,0,-170
20578,1,1,1490,4142,2652
20579,1,0,22,0,-22
20580,1,0,14,0,-14
20581,0,0,43,0,-43
20582,1,0,1,0,-1
20583,1,1,29,1559,1530
20584,1,0,115,0,-115
20585,0,0,7,0,-7
20586,1,1,232,1360,1128
20587,1,0,3,0,-3
20588,1,1,727,1705,978
20589,0,0,24,0,-24
20590,1,0,40,0,-40
20591,0,0,77,0,-77
20592,0,0,2,0,-2
20593,0,0,109,0,-109
20594,0,0,57,0,-57
20595,1,1,609,1308,699
20596,0,0,12,0,-12
20597,0,0,8,0,-8
20598,1,0,60,0,-60
20599,0,0,10,0,-10
20600,1,1,734,1714,980
20601,0,0,345,0,-345
20602,1,0,137,0,-137
20603,1,0,37,0,-37
20604,0,0,9,0,-9
20605,1,1,358,2999,2641
20606,0,0,85,0,-85
20607,1,0,9,0,-9
20608,1,0,16,0,-16
20609,1,0,122,0,-122
20610,1,1,480,1698,1218
20611,0,0,24,0,-24
20612,0,0,20,0,-20
20613,1,1,969,1440,471
20614,1,0,122,0,-122
20615,0,0,9,0,-9
20616,1,0,108,0,-108
20617,0,0,43,0,-43
20618,0,0,3,0,-3
20619,1,1,362,1305,943
20620,1,0,71,0,-71
20621,0,0,24,0,-24
20622,0,0,31,0,-31
20623,1,1,154,1330,1176
20624,1,0,91,0,-91
20625,1,0,25,0,-25
20626,1,0,102,0,-102
20627,1,1,847,1224,377
20628,1,0,37,0,-37
20629,1,1,46,1352,1306
20630,1,0,7,0,-7
20631,0,0,7,0,-7
20632,0,0,10,0,-10
20633,0,0,13,0,-13
20634,1,0,77,0,-77
20635,0,0,26,0,-26
20636,1,1,416,1210,794
20637,1,1,294,2664,2370
20638,1,1,404,1292,888
20639,0,0,39,0,-39
20640,1,0,43,0,-43
20641,1,0,0,0,0
20642,1,0,182,0,-182
20643,1,0,60,0,-60
20644,1,0,10,0,-10
20645,1,0,14,0,-14
20646,1,1,618,1229,611
20647,1,0,32,0,-32
20648,1,1,1327,2208,881
20649,0,0,47,0,-47
20650,1,1,526,1463,937
20651,0,0,63,0,-63
20652,1,0,70,0,-70
20653,1,0,220,0,-220
20654,0,0,53,0,-53
20655,0,0,19,0,-19
20656,0,0,87,0,-87
20657,1,1,2772,1652,-1120
20658,1,0,49,0,-49
20659,1,0,6,0,-6
20660,0,0,75,0,-75
20661,0,0,1,0,-1
20662,1,0,21,0,-21
20663,1,0,237,0,-237
20664,0,0,12,0,-12
20665,1,1,1579,1204,-375
20666,1,0,27,0,-27
20667,1,0,31,0,-31
20668,1,1,1814,2353,539
20669,1,0,45,0,-45
20670,0,0,97,0,-97
20671,1,1,2548,2074,-474
20672,0,0,33,0,-33
20673,0,0,28,0,-28
20674,0,0,1,0,-1
20675,0,0,123,0,-123
20676,1,0,27,0,-27
20677,0,0,21,0,-21
20678,1,0,58,0,-58
20679,0,0,17,0,-17
20680,1,1,915,1906,991
20681,1,1,333,1831,1498
20682,1,1,324,1285,961
20683,0,0,158,0,-158
20684,1,0,96,0,-96
20685,1,0,10,0,-10
20686,0,0,16,0,-16
20687,0,0,5,0,-5
20688,1,1,157,1279,1122
20689,1,0,148,0,-148
20690,0,0,40,0,-40
20691,1,0,42,0,-42
20692,1,0,3,0,-3
20693,1,1,439,1377,938
20694,1,0,33,0,-33
20695,0,0,2,0,-2
20696,1,1,63,1448,1385
20697,1,0,25,0,-25
20698,0,0,64,0,-64
20699,1,0,46,0,-46
20700,0,0,10,0,-10
20701,1,0,5,0,-5
20702,0,0,61,0,-61
20703,0,0,65,0,-65
20704,1,1,59,1543,1484
20705,1,0,13,0,-13
20706,1,1,323,1201,878
20707,0,0,54,0,-54
20708,0,0,49,0,-49
20709,1,1,314,1627,1313
20710,1,1,124,1808,1684
20711,1,1,1386,1446,60
20712,0,0,25,0,-25
20713,1,1,100,1330,1230
20714,1,1,401,1387,986
20715,1,0,70,0,-70
20716,1,1,962,1374,412
20717,1,0,72,0,-72
20718,1,0,185,0,-185
20719,1,1,2260,1665,-595
20720,0,0,9,0,-9
20721,1,0,170,0,-170
20722,0,0,78,0,-78
20723,1,1,1203,1621,418
20724,1,1,121,1989,1868
20725,0,0,171,0,-171
20726,0,0,9,0,-9
20727,1,0,191,0,-191
20728,1,1,268,1447,1179
20729,0,0,19,0,-19
20730,1,1,181,2661,2480
20731,0,0,38,0,-38
20732,1,0,1,0,-1
20733,1,0,36,0,-36
20734,0,0,68,0,-68
20735,1,0,81,0,-81
20736,1,1,799,1214,415
20737,1,0,89,0,-89
20738,0,0,5,0,-5
20739,0,0,30,0,-30
20740,0,0,21,0,-21
20741,1,1,44,1409,1365
20742,0,0,64,0,-64
20743,1,0,52,0,-52
20744,1,1,961,1337,376
20745,0,0,55,0,-55
20746,1,1,159,1290,1131
20747,1,0,82,0,-82
20748,1,1,308,1650,1342
20749,0,0,6,0,-6
20750,1,1,129,1344,1215
20751,1,1,655,2703,2048
20752,0,0,19,0,-19
20753,1,0,57,0,-57
20754,0,0,4,0,-4
20755,1,0,26,0,-26
20756,1,1,1615,1917,302
20757,0,0,79,0,-79
20758,0,0,32,0,-32
20759,1,0,10,0,-10
20760,1,1,309,1438,1129
20761,1,0,55,0,-55
20762,1,1,1078,1307,229
20763,1,0,11,0,-11
20764,0,0,8,0,-8
20765,0,0,88,0,-88
20766,0,0,110,0,-110
20767,0,0,183,0,-183
20768,0,0,131,0,-131
20769,1,1,842,1365,523
20770,0,0,0,0,0
20771,1,1,280,1807,1527
20772,1,0,19,0,-19
20773,1,1,327,1254,927
20774,0,0,174,0,-174
20775,1,0,2,0,-2
20776,1,0,4,0,-4
20777,0,0,365,0,-365
20778,1,0,86,0,-86
20779,0,0,27,0,-27
20780,0,0,18,0,-18
20781,0,0,38,0,-38
20782,0,0,9,0,-9
20783,1,1,1381,1263,-118
20784,0,0,32,0,-32
20785,1,0,10,0,-10
20786,0,0,19,0,-19
20787,1,1,123,1562,1439
20788,0,0,63,0,-63
20789,0,0,4,0,-4
20790,1,0,32,0,-32
20791,0,0,43,0,-43
20792,1,0,4,0,-4
20793,1,0,20,0,-20
20794,0,0,3,0,-3
20795,1,0,48,0,-48
20796,1,1,635,1540,905
20797,0,0,58,0,-58
20798,0,0,0,0,0
20799,0,0,52,0,-52
20800,1,1,212,1482,1270
20801,0,0,19,0,-19
20802,0,0,0,0,0
20803,0,0,3,0,-3
20804,1,0,54,0,-54
20805,0,0,40,0,-40
20806,0,0,32,0,-32
20807,1,0,48,0,-48
20808,1,1,129,1406,1277
20809,1,0,38,0,-38
20810,1,1,192,1548,1356
20811,0,0,14,0,-14
20812,1,1,380,1480,1100
20813,1,0,58,0,-58
20814,0,0,25,0,-25
20815,1,0,4,0,-4
20816,1,1,468,1424,956
20817,1,1,161,1256,1095
20818,1,0,8,0,-8
20819,1,0,34,0,-34
20820,1,0,32,0,-32
20821,0,0,91,0,-91
20822,1,1,347,1282,935
20823,1,0,69,0,-69
20824,0,0,48,0,-48
20825,1,0,13,0,-13
20826,0,0,111,0,-111
20827,1,0,86,0,-86
20828,1,0,112,0,-112
20829,0,0,98,0,-98
20830,0,0,102,0,-102
20831,1,0,0,0,0
20832,1,0,11,0,-11
20833,0,0,143,0,-143
20834,1,1,320,3217,2897
20835,0,0,205,0,-205
20836,0,0,15,0,-15
20837,0,0,7,0,-7
20838,1,0,79,0,-79
20839,0,0,8,0,-8
20840,1,0,39,0,-39
20841,0,0,19,0,-19
20842,0,0,24,0,-24
20843,1,1,151,1266,1115
20844,1,1,664,1441,777
20845,0,0,130,0,-130
20846,1,1,218,1438,1220
20847,1,1,173,1336,1163
20848,0,0,44,0,-44
20849,1,0,15,0,-15
20850,1,1,137,1404,1267
20851,0,0,17,0,-17
20852,1,0,98,0,-98
20853,1,0,42,0,-42
20854,1,1,188,2298,2110
20855,1,0,124,0,-124
20856,0,0,106,0,-106
20857,1,0,0,0,0
20858,0,0,122,0,-122
20859,0,0,10,0,-10
20860,1,1,748,1778,1030
20861,1,0,57,0,-57
20862,1,1,600,1296,696
20863,0,0,10,0,-10
20864,1,0,67,0,-67
20865,0,0,0,0,0
20866,0,0,28,0,-28
20867,0,0,36,0,-36
20868,1,0,62,0,-62
20869,1,1,433,1532,1099
20870,1,1,275,1579,1304
20871,0,0,17,0,-17
20872,1,1,1247,1236,-11
20873,0,0,202,0,-202
20874,1,1,232,1606,1374
20875,0,0,1,0,-1
20876,1,0,6,0,-6
20877,1,0,190,0,-190
20878,1,1,402,3248,2846
20879,1,1,143,1457,1314
20880,1,0,117,0,-117
20881,0,0,15,0,-15
20882,1,0,22,0,-22
20883,1,1,621,1285,664
20884,1,1,219,1612,1393
20885,0,0,5,0,-5
20886,1,0,47,0,-47
20887,1,1,60,1352,1292
20888,1,1,1944,1321,-623
20889,0,0,47,0,-47
20890,0,0,1,0,-1
20891,1,0,107,0,-107
20892,1,1,3200,1554,-1646
20893,1,1,189,1317,1128
20894,0,0,92,0,-92
20895,0,0,29,0,-29
20896,0,0,170,0,-170
20897,0,0,105,0,-105
20898,1,1,1649,1293,-356
20899,1,0,47,0,-47
20900,1,0,28,0,-28
20901,0,0,64,0,-64
20902,1,1,208,1217,1009
20903,1,1,276,1807,1531
20904,0,0,31,0,-31
20905,1,0,52,0,-52
20906,0,0,0,0,0
20907,0,0,75,0,-75
20908,1,0,142,0,-142
20909,1,1,690,1301,611
20910,1,1,673,2159,1486
20911,1,0,59,0,-59
20912,1,1,398,1904,1506
20913,1,0,168,0,-168
20914,1,1,90,1293,1203
20915,0,0,158,0,-158
20916,0,0,103,0,-103
20917,0,0,54,0,-54
20918,1,1,31,1241,1210
20919,0,0,59,0,-59
20920,0,0,27,0,-27
20921,1,0,26,0,-26
20922,0,0,6,0,-6
20923,1,1,401,1600,1199
20924,0,0,104,0,-104
20925,1,0,88,0,-88
20926,1,0,6,0,-6
20927,1,1,716,1452,736
20928,0,0,77,0,-77
20929,1,0,11,0,-11
20930,0,0,12,0,-12
20931,0,0,49,0,-49
20932,1,0,0,0,0
20933,0,0,3,0,-3
20934,1,1,54,1241,1187
20935,0,0,4,0,-4
20936,1,1,412,1271,859
20937,0,0,0,0,0
20938,0,0,15,0,-15
20939,1,1,806,1856,1050
20940,0,0,30,0,-30
20941,1,0,143,0,-143
20942,0,0,100,0,-100
20943,0,0,7,0,-7
20944,1,1,1106,1292,186
20945,1,0,88,0,-88
20946,1,0,30,0,-30
20947,1,1,634,1268,634
20948,1,0,147,0,-147
20949,1,0,0,0,0
20950,1,0,14,0,-14
20951,0,0,57,0,-57
20952,0,0,29,0,-29
20953,1,0,36,0,-36
20954,0,0,19,0,-19
20955,0,0,52,0,-52
20956,1,1,457,1341,884
20957,1,1,792,1927,1135
20958,0,0,48,0,-48
20959,1,0,31,0,-31
20960,0,0,10,0,-10
20961,0,0,44,0,-44
20962,0,0,27,0,-27
20963,0,0,27,0,-27
20964,0,0,168,0,-168
20965,1,0,7,0,-7
20966,1,0,74,0,-74
20967,1,0,27,0,-27
20968,1,0,17,0,-17
20969,1,1,296,1375,1079
20970,1,1,418,1225,807
20971,1,0,70,0,-70
20972,0,0,30,0,-30
20973,0,0,1,0,-1
20974,1,0,101,0,-101
20975,1,1,548,2088,1540
20976,1,0,0,0,0
20977,0,0,9,0,-9
20978,0,0,79,0,-79
20979,0,0,52,0,-52
20980,0,0,7,0,-7
20981,1,0,49,0,-49
20982,1,0,87,0,-87
20983,0,0,31,0,-31
20984,0,0,2,0,-2
20985,0,0,26,0,-26
20986,1,0,43,0,-43
20987,1,1,287,2328,2041
20988,0,0,25,0,-25
20989,1,1,33,1796,1763
20990,0,0,5,0,-5
20991,0,0,13,0,-13
20992,1,1,140,1305,1165
20993,1,1,287,1593,1306
20994,1,1,208,1245,1037
20995,0,0,21,0,-21
20996,1,1,36,1202,1166
20997,0,0,63,0,-63
20998,1,0,8,0,-8
20999,1,1,122,1284,1162
21000,1,0,49,0,-49
21001,1,1,333,1345,1012
21002,0,0,37,0,-37
21003,1,1,463,1690,1227
21004,0,0,23,0,-23
21005,1,0,9,0,-9
21006,1,0,113,0,-113
21007,1,1,182,1842,1660
21008,1,0,11,0,-11
21009,0,0,56,0,-56
21010,0,0,3,0,-3
21011,1,0,12,0,-12
21012,0,0,50,0,-50
21013,1,1,1210,1410,200
21014,1,1,2073,1335,-738
21015,0,0,8,0,-8
21016,1,1,272,1208,936
21017,1,0,89,0,-89
21018,0,0,97,0,-97
21019,1,0,34,0,-34
21020,1,0,3,0,-3
21021,1,1,326,1257,931
21022,1,0,6,0,-6
21023,1,0,11,0,-11
21024,1,1,723,1500,777
21025,1,0,12,0,-12
21026,1,1,519,1351,832
21027,0,0,150,0,-150
21028,0,0,31,0,-31
21029,0,0,8,0,-8
21030,1,0,59,0,-59
21031,1,0,42,0,-42
21032,0,0,163,0,-163
21033,0,0,56,0,-56
21034,0,0,70,0,-70
21035,1,0,8,0,-8
21036,1,1,1150,1728,578
21037,1,0,121,0,-121
21038,1,1,21,1381,1360
21039,0,0,7,0,-7
21040,1,0,16,0,-16
21041,1,0,114,0,-114
21042,1,1,271,2278,2007
21043,1,1,337,1318,981
21044,0,0,4,0,-4
21045,0,0,11,0,-11
21046,1,0,22,0,-22
21047,0,0,194,0,-194
21048,1,0,15,0,-15
21049,1,0,58,0,-58
21050,0,0,17,0,-17
21051,1,0,7,0,-7
21052,0,0,3,0,-3
21053,0,0,15,0,-15
21054,1,1,103,1211,1108
21055,0,0,58,0,-58
21056,1,1,559,1230,671
21057,1,1,32,2635,2603
21058,1,0,82,0,-82
21059,1,0,16,0,-16
21060,0,0,9,0,-9
21061,1,1,181,1236,1055
21062,1,0,79,0,-79
21063,1,0,8,0,-8
21064,1,0,192,0,-192
21065,1,0,6,0,-6
21066,0,0,61,0,-61
21067,1,0,38,0,-38
21068,0,0,48,0,-48
21069,0,0,4,0,-4
21070,1,1,180,1509,1329
21071,1,1,291,1234,943
21072,0,0,62,0,-62
21073,0,0,32,0,-32
21074,0,0,98,0,-98
21075,1,1,2280,1459,-821
21076,0,0,62,0,-62
21077,1,0,2,0,-2
21078,1,1,924,1307,383
21079,1,1,760,1450,690
21080,0,0,28,0,-28
21081,1,0,44,0,-44
21082,0,0,65,0,-65
21083,0,0,47,0,-47
21084,0,0,24,0,-24
21085,1,1,248,1461,1213
21086,1,1,373,1379,1006
21087,1,1,457,1415,958
21088,0,0,11,0,-11
21089,0,0,66,0,-66
21090,0,0,278,0,-278
21091,1,0,18,0,-18
21092,1,1,381,1211,830
21093,1,0,3,0,-3
21094,1,1,624,1370,746
21095,0,0,24,0,-24
21096,1,1,115,1301,1186
21097,0,0,3,0,-3
21098,1,1,1226,1362,136
21099,0,0,17,0,-17
21100,1,1,126,1284,1158
21101,1,1,90,1668,1578
21102,1,1,472,1225,753
21103,0,0,103,0,-103
21104,0,0,23,0,-23
21105,0,0,10,0,-10
21106,1,1,604,1674,1070
21107,1,0,1,0,-1
21108,1,1,94,2472,2378
21109,1,1,34,1409,1375
21110,1,1,93,1231,1138
21111,0,0,104,0,-104
21112,1,1,960,1559,599
21113,0,0,23,0,-23
21114,1,0,1,0,-1
21115,0,0,90,0,-90
21116,1,0,11,0,-11
21117,0,0,53,0,-53
21118,0,0,52,0,-52
21119,1,0,26,0,-26
21120,1,0,48,0,-48
21121,0,0,24,0,-24
21122,0,0,31,0,-31
21123,1,0,89,0,-89
21124,1,1,276,1396,1120
21125,1,0,29,0,-29
21126,1,0,94,0,-94
21127,0,0,17,0,-17
21128,1,0,204,0,-204
21129,0,0,31,0,-31
21130,1,1,2046,1503,-543
21131,0,0,1,0,-1
21132,0,0,22,0,-22
21133,0,0,16,0,-16
21134,1,1,598,1227,629
21135,1,1,170,1515,1345
21136,1,0,122,0,-122
21137,1,0,36,0,-36
21138,0,0,16,0,-16
21139,1,1,233,2410,2177
21140,1,0,19,0,-19
21141,1,1,158,4615,4457
21142,0,0,96,0,-96
21143,0,0,26,0,-26
21144,1,0,1,0,-1
21145,0,0,273,0,-273
21146,0,0,5,0,-5
21147,0,0,61,0,-61
21148,0,0,0,0,0
21149,1,1,200,1405,1205
21150,0,0,15,0,-15
21151,1,1,155,1467,1312
21152,1,1,374,1336,962
21153,0,0,26,0,-26
21154,1,1,77,1252,1175
21155,0,0,77,0,-77
21156,1,0,12,0,-12
21157,0,0,123,0,-123
21158,1,1,1416,1355,-61
21159,1,1,146,1305,1159
21160,1,0,58,0,-58
21161,1,0,39,0,-39
21162,1,0,17,0,-17
21163,0,0,38,0,-38
21164,1,1,374,1261,887
21165,1,1,115,1842,1727
21166,1,1,397,1450,1053
21167,1,0,33,0,-33
21168,0,0,3,0,-3
21169,0,0,0,0,0
21170,1,1,585,1275,690
21171,1,1,737,1396,659
21172,0,0,84,0,-84
21173,1,0,7,0,-7
21174,1,1,209,1226,1017
21175,1,0,9,0,-9
21176,1,0,141,0,-141
21177,1,1,589,1918,1329
21178,1,0,18,0,-18
21179,1,0,14,0,-14
21180,1,0,25,0,-25
21181,1,1,854,1216,362
21182,0,0,1,0,-1
21183,1,0,57,0,-57
21184,1,0,20,0,-20
21185,1,0,195,0,-195
21186,1,0,30,0,-30
21187,0,0,97,0,-97
21188,1,0,1,0,-1
21189,1,0,45,0,-45
21190,1,0,154,0,-154
21191,0,0,52,0,-52
21192,1,0,108,0,-108
21193,1,1,177,1228,1051
21194,1,0,20,0,-20
21195,1,0,2,0,-2
21196,1,1,901,2080,1179
21197,0,0,31,0,-31
21198,1,1,249,2211,1962
21199,1,0,28,0,-28
21200,1,0,33,0,-33
21201,0,0,57,0,-57
21202,1,0,23,0,-23
21203,0,0,188,0,-188
21204,0,0,53,0,-53
21205,0,0,101,0,-101
21206,1,0,22,0,-22
21207,0,0,10,0,-10
21208,1,1,265,1387,1122
21209,0,0,203,0,-203
21210,1,0,13,0,-13
21211,1,1,1353,3450,2097
21212,0,0,14,0,-14
21213,1,1,104,1214,1110
21214,0,0,92,0,-92
21215,1,1,425,2113,1688
21216,1,0,19,0,-19
21217,0,0,8,0,-8
21218,1,0,65,0,-65
21219,1,1,395,1345,950
21220,0,0,27,0,-27
21221,1,0,59,0,-59
21222,1,1,87,2082,1995
21223,1,0,35,0,-35
21224,1,0,5,0,-5
21225,1,0,90,0,-90
21226,0,0,18,0,-18
21227,0,0,21,0,-21
21228,0,0,64,0,-64
21229,0,0,147,0,-147
21230,1,1,594,1658,1064
21231,0,0,113,0,-113
21232,1,0,7,0,-7
21233,1,1,1089,1217,128
21234,0,0,7,0,-7
21235,1,0,17,0,-17
21236,0,0,228,0,-228
21237,0,0,86,0,-86
21238,1,0,107,0,-107
21239,1,0,29,0,-29
21240,1,1,871,1263,392
21241,1,0,6,0,-6
21242,0,0,5,0,-5
21243,1,0,57,0,-57
21244,1,0,45,0,-45
21245,1,1,575,1209,634
21246,0,0,5,0,-5
21247,1,0,48,0,-48
21248,1,0,72,0,-72
21249,1,0,33,0,-33
21250,0,0,5,0,-5
21251,1,1,68,1443,1375
21252,0,0,47,0,-47
21253,1,1,665,3257,2592
21254,1,0,90,0,-90
21255,1,1,590,1242,652
21256,0,0,15,0,-15
21257,1,1,616,1950,1334
21258,1,1,61,1475,1414
21259,1,0,52,0,-52
21260,1,1,2352,1433,-919
21261,1,1,304,1225,921
21262,1,0,75,0,-75
21263,1,1,86,1783,1697
21264,0,0,221,0,-221
21265,0,0,99,0,-99
21266,1,1,87,3181,3094
21267,1,1,272,1442,1170
21268,0,0,43,0,-43
21269,1,0,40,0,-40
21270,1,1,219,2084,1865
21271,0,0,0,0,0
21272,1,1,206,1520,1314
21273,0,0,33,0,-33
21274,0,0,20,0,-20
21275,0,0,11,0,-11
21276,1,1,288,1400,1112
21277,1,0,52,0,-52
21278,1,0,86,0,-86
21279,1,1,142,1567,1425
21280,1,0,3,0,-3
21281,0,0,44,0,-44
21282,1,1,26,1356,1330
21283,0,0,27,0,-27
21284,1,0,46,0,-46
21285,1,1,150,1207,1057
21286,1,1,820,1282,462
21287,0,0,30,0,-30
21288,0,0,38,0,-38
21289,1,0,11,0,-11
21290,1,0,230,0,-230
21291,1,1,846,1438,592
21292,0,0,98,0,-98
21293,0,0,32,0,-32
21294,1,1,745,1834,1089
21295,1,0,61,0,-61
21296,1,1,1174,1286,112
21297,0,0,87,0,-87
21298,0,0,14,0,-14
21299,0,0,14,0,-14
21300,1,1,158,1220,1062
21301,0,0,92,0,-92
21302,1,1,104,1214,1110
21303,1,1,480,1383,903
21304,0,0,43,0,-43
21305,1,0,16,0,-16
21306,0,0,13,0,-13
21307,1,0,73,0,-73
21308,0,0,102,0,-102
21309,1,1,144,1918,1774
21310,1,1,577,1548,971
21311,0,0,32,0,-32
21312,0,0,64,0,-64
21313,1,0,4,0,-4
21314,1,0,106,0,-106
21315,1,0,1,0,-1
21316,1,0,57,0,-57
21317,1,0,0,0,0
21318,0,0,94,0,-94
21319,1,1,302,1310,1008
21320,1,0,31,0,-31
21321,1,0,42,0,-42
21322,1,0,24,0,-24
21323,1,0,5,0,-5
21324,0,0,18,0,-18
21325,0,0,6,0,-6
21326,1,0,205,0,-205
21327,1,1,472,1234,762
21328,1,0,27,0,-27
21329,0,0,135,0,-135
21330,0,0,48,0,-48
21331,1,1,496,1304,808
21332,1,1,442,2003,1561
21333,1,1,747,1446,699
21334,1,1,656,2391,1735
21335,1,0,8,0,-8
21336,0,0,0,0,0
21337,1,1,244,1217,973
21338,1,0,40,0,-40
21339,1,0,64,0,-64
21340,1,1,66,1540,1474
21341,1,0,34,0,-34
21342,0,0,1,0,-1
21343,0,0,38,0,-38
21344,0,0,25,0,-25
21345,1,1,176,1539,1363
21346,1,1,969,1287,318
21347,1,1,542,1317,775
21348,1,0,35,0,-35
21349,1,1,616,1371,755
21350,0,0,34,0,-34
21351,1,1,74,1239,1165
21352,1,0,158,0,-158
21353,0,0,121,0,-121
21354,0,0,107,0,-107
21355,0,0,11,0,-11
21356,0,0,73,0,-73
21357,0,0,0,0,0
21358,1,0,103,0,-103
21359,0,0,126,0,-126
21360,1,1,1152,1494,342
21361,1,0,75,0,-75
21362,1,0,8,0,-8
21363,1,0,62,0,-62
21364,1,1,2790,1727,-1063
21365,1,0,15,0,-15
21366,0,0,50,0,-50
21367,1,1,67,1816,1749
21368,1,0,4,0,-4
21369,0,0,58,0,-58
21370,1,0,202,0,-202
21371,1,0,55,0,-55
21372,1,0,24,0,-24
21373,1,1,527,1284,757
21374,1,0,4,0,-4
21375,1,0,198,0,-198
21376,1,0,11,0,-11
21377,1,0,128,0,-128
21378,1,1,1143,1288,145
21379,1,0,133,0,-133
21380,1,0,42,0,-42
21381,1,1,400,1572,1172
21382,1,0,28,0,-28
21383,1,1,460,1454,994
21384,1,0,80,0,-80
21385,0,0,265,0,-265
21386,1,1,1062,1246,184
21387,0,0,19,0,-19
21388,1,1,733,1471,738
21389,1,1,373,2023,1650
21390,0,0,12,0,-12
21391,1,0,30,0,-30
21392,0,0,18,0,-18
21393,0,0,53,0,-53
21394,1,1,765,1525,760
21395,0,0,15,0,-15
21396,0,0,56,0,-56
21397,1,1,37,1375,1338
21398,1,0,4,0,-4
21399,1,1,712,1801,1089
21400,1,0,13,0,-13
21401,0,0,32,0,-32
21402,1,1,846,1322,476
21403,1,0,28,0,-28
21404,0,0,106,0,-106
21405,1,1,78,1236,1158
21406,1,1,470,2359,1889
21407,0,0,7,0,-7
21408,0,0,131,0,-131
21409,1,1,52,1305,1253
21410,0,0,102,0,-102
21411,1,0,28,0,-28
21412,0,0,70,0,-70
21413,0,0,68,0,-68
21414,1,0,79,0,-79
21415,1,0,22,0,-22
21416,0,0,45,0,-45
21417,1,1,733,1540,807
21418,1,0,27,0,-27
21419,1,1,198,1921,1723
21420,0,0,6,0,-6
21421,0,0,76,0,-76
21422,0,0,49,0,-49
21423,0,0,33,0,-33
21424,0,0,57,0,-57
21425,0,0,7,0,-7
21426,0,0,25,0,-25
21427,0,0,3,0,-3
21428,0,0,0,0,0
21429,1,0,113,0,-113
21430,0,0,81,0,-81
21431,0,0,184,0,-184
21432,1,0,0,0,0
21433,0,0,43,0,-43
21434,1,0,14,0,-14
21435,0,0,16,0,-16
21436,1,0,47,0,-47
21437,0,0,9,0,-9
21438,0,0,58,0,-58
21439,1,1,64,1404,1340
21440,1,0,60,0,-60
21441,1,0,107,0,-107
21442,0,0,4,0,-4
21443,0,0,7,0,-7
21444,1,1,509,1441,932
21445,1,0,13,0,-13
21446,0,0,61,0,-61
21447,0,0,20,0,-20
21448,0,0,61,0,-61
21449,0,0,121,0,-121
21450,1,1,213,1700,1487
21451,1,0,24,0,-24
21452,0,0,11,0,-11
21453,1,0,125,0,-125
21454,0,0,18,0,-18
21455,1,0,180,0,-180
21456,1,0,38,0,-38
21457,0,0,20,0,-20
21458,1,0,51,0,-51
21459,0,0,1,0,-1
21460,0,0,48,0,-48
21461,0,0,286,0,-286
21462,1,0,75,0,-75
21463,1,1,542,1779,1237
21464,0,0,137,0,-137
21465,1,1,992,1254,262
21466,1,1,78,1328,1250
21467,0,0,171,0,-171
21468,0,0,40,0,-40
21469,1,1,719,1423,704
21470,0,0,138,0,-138
21471,1,1,954,1294,340
21472,1,1,864,1213,349
21473,1,1,888,1548,660
21474,0,0,131,0,-131
21475,1,0,20,0,-20
21476,1,1,832,1393,561
21477,1,0,79,0,-79
21478,0,0,138,0,-138
21479,0,0,73,0,-73
21480,1,0,41,0,-41
21481,1,1,200,1578,1378
21482,1,0,9,0,-9
21483,0,0,148,0,-148
21484,1,0,73,0,-73
21485,0,0,30,0,-30
21486,1,0,67,0,-67
21487,0,0,29,0,-29
21488,1,1,348,1354,1006
21489,1,1,738,1794,1056
21490,1,1,523,1596,1073
21491,1,1,340,1570,1230
21492,0,0,25,0,-25
21493,0,0,76,0,-76
21494,1,0,0,0,0
21495,1,1,484,1797,1313
21496,1,1,207,1267,1060
21497,1,0,79,0,-79
21498,1,1,799,1338,539
21499,0,0,139,0,-139
21500,0,0,29,0,-29
21501,0,0,38,0,-38
21502,1,0,72,0,-72
21503,0,0,1,0,-1
21504,0,0,62,0,-62
21505,1,1,235,1364,1129
21506,1,0,234,0,-234
21507,0,0,15,0,-15
21508,0,0,125,0,-125
21509,0,0,6,0,-6
21510,0,0,44,0,-44
21511,1,1,264,1857,1593
21512,0,0,12,0,-12
21513,1,0,18,0,-18
21514,0,0,137,0,-137
21515,1,1,301,1287,986
21516,0,0,48,0,-48
21517,1,0,17,0,-17
21518,0,0,29,0,-29
21519,1,1,1384,1207,-177
21520,1,1,197,1420,1223
21521,1,1,1091,1281,190
21522,1,0,14,0,-14
21523,0,0,32,0,-32
21524,0,0,90,0,-90
21525,0,0,75,0,-75
21526,0,0,25,0,-25
21527,0,0,8,0,-8
21528,1,0,1,0,-1
21529,0,0,17,0,-17
21530,0,0,60,0,-60
21531,1,1,1576,1497,-79
21532,1,0,39,0,-39
21533,1,1,965,1265,300
21534,0,0,22,0,-22
21535,1,0,80,0,-80
21536,0,0,4,0,-4
21537,0,0,260,0,-260
21538,1,0,23,0,-23
21539,0,0,8,0,-8
21540,1,1,613,1296,683
21541,1,1,259,1391,1132
21542,1,0,20,0,-20
21543,1,1,575,1220,645
21544,0,0,41,0,-41
21545,0,0,32,0,-32
21546,0,0,34,0,-34
21547,1,0,92,0,-92
21548,0,0,0,0,0
21549,1,1,1367,1376,9
21550,1,1,514,1361,847
21551,0,0,240,0,-240
21552,1,0,8,0,-8
21553,1,0,83,0,-83
21554,1,1,454,1234,780
21555,1,1,432,1660,1228
21556,1,1,535,1219,684
21557,1,1,181,1336,1155
21558,1,1,550,1253,703
21559,0,0,3,0,-3
21560,1,0,31,0,-31
21561,1,0,2,0,-2
21562,1,1,828,1425,597
21563,0,0,9,0,-9
21564,0,0,75,0,-75
21565,1,0,85,0,-85
21566,1,1,312,1209,897
21567,1,1,258,1283,1025
21568,1,1,468,1470,1002
21569,1,1,999,2145,1146
21570,0,0,21,0,-21
21571,1,1,329,1533,1204
21572,0,0,43,0,-43
21573,1,1,375,1540,1165
21574,1,1,457,1263,806
21575,1,1,365,1269,904
21576,1,0,15,0,-15
21577,0,0,45,0,-45
21578,0,0,4,0,-4
21579,1,0,41,0,-41
21580,0,0,39,0,-39
21581,1,1,421,1246,825
21582,0,0,42,0,-42
21583,0,0,195,0,-195
21584,0,0,91,0,-91
21585,0,0,87,0,-87
21586,0,0,21,0,-21
21587,1,0,1,0,-1
21588,1,1,68,1227,1159
21589,1,1,375,1338,963
21590,0,0,56,0,-56
21591,0,0,57,0,-57
21592,0,0,31,0,-31
21593,1,0,3,0,-3
21594,0,0,23,0,-23
21595,1,1,456,1371,915
21596,1,1,319,1544,1225
21597,0,0,31,0,-31
21598,1,0,116,0,-116
21599,1,0,14,0,-14
21600,0,0,389,0,-389
21601,1,1,1011,1393,382
21602,1,1,353,1325,972
21603,0,0,80,0,-80
21604,0,0,15,0,-15
21605,1,0,46,0,-46
21606,0,0,211,0,-211
21607,0,0,43,0,-43
21608,1,0,78,0,-78
21609,1,1,1191,1357,166
21610,1,0,41,0,-41
21611,1,1,75,1706,1631
21612,1,1,132,1714,1582
21613,1,0,139,0,-139
21614,1,1,37,1952,1915
21615,0,0,26,0,-26
21616,0,0,8,0,-8
21617,1,0,51,0,-51
21618,1,0,0,0,0
21619,1,1,547,1310,763
21620,1,1,61,1340,1279
21621,0,0,26,0,-26
21622,1,0,40,0,-40
21623,1,0,25,0,-25
21624,1,0,89,0,-89
21625,1,1,327,1720,1393
21626,1,1,468,1325,857
21627,1,1,393,2056,1663
21628,1,0,77,0,-77
21629,1,0,18,0,-18
21630,0,0,14,0,-14
21631,1,0,10,0,-10
21632,1,1,1070,1365,295
21633,1,0,57,0,-57
21634,0,0,62,0,-62
21635,1,1,518,1261,743
21636,1,0,36,0,-36
21637,1,1,696,1673,977
21638,0,0,4,0,-4
21639,1,1,153,1232,1079
21640,1,0,35,0,-35
21641,1,0,0,0,0
21642,1,0,55,0,-55
21643,0,0,60,0,-60
21644,0,0,30,0,-30
21645,1,0,3,0,-3
21646,0,0,0,0,0
21647,1,1,448,1345,897
21648,1,0,103,0,-103
21649,1,1,1725,1539,-186
21650,0,0,27,0,-27
21651,1,1,841,1940,1099
21652,1,0,107,0,-107
21653,0,0,89,0,-89
21654,1,1,476,1231,755
21655,1,0,4,0,-4
21656,0,0,119,0,-119
21657,1,0,23,0,-23
21658,1,0,7,0,-7
21659,1,1,178,1337,1159
21660,0,0,154,0,-154
21661,1,1,363,1330,967
21662,1,0,3,0,-3
21663,1,0,27,0,-27
21664,1,0,236,0,-236
21665,1,1,325,1661,1336
21666,1,0,1,0,-1
21667,1,1,213,1254,1041
21668,1,0,53,0,-53
21669,1,0,36,0,-36
21670,1,1,108,1231,1123
21671,1,1,467,1555,1088
21672,1,0,255,0,-255
21673,1,1,962,1381,419
21674,0,0,30,0,-30
21675,0,0,25,0,-25
21676,1,1,579,1792,1213
21677,0,0,128,0,-128
21678,1,0,19,0,-19
21679,1,0,32,0,-32
21680,1,1,2077,1407,-670
21681,1,0,152,0,-152
21682,0,0,3,0,-3
21683,0,0,9,0,-9
21684,0,0,29,0,-29
21685,1,1,503,1348,845
21686,0,0,33,0,-33
21687,1,0,14,0,-14
21688,0,0,38,0,-38
21689,1,1,351,1237,886
21690,1,0,56,0,-56
21691,0,0,45,0,-45
21692,1,1,363,1399,1036
21693,1,0,5,0,-5
21694,1,0,6,0,-6
21695,1,0,33,0,-33
21696,0,0,50,0,-50
21697,0,0,6,0,-6
21698,0,0,58,0,-58
21699,1,0,62,0,-62
21700,1,1,186,1449,1263
21701,0,0,0,0,0
21702,1,1,272,2061,1789
21703,0,0,28,0,-28
21704,0,0,17,0,-17
21705,0,0,23,0,-23
21706,0,0,26,0,-26
21707,1,1,624,1900,1276
21708,1,0,38,0,-38
21709,0,0,9,0,-9
21710,1,1,71,1470,1399
21711,0,0,121,0,-121
21712,1,1,135,1413,1278
21713,1,1,185,1922,1737
21714,1,0,12,0,-12
21715,1,1,374,1403,1029
21716,0,0,2,0,-2
21717,1,0,2,0,-2
21718,0,0,37,0,-37
21719,1,1,227,2866,2639
21720,1,1,1038,2051,1013
21721,1,0,4,0,-4
21722,0,0,1,0,-1
21723,1,0,1,0,-1
21724,1,0,19,0,-19
21725,0,0,146,0,-146
21726,0,0,118,0,-118
21727,1,0,55,0,-55
21728,1,0,48,0,-48
21729,1,0,29,0,-29
21730,1,1,1104,1862,758
21731,1,0,72,0,-72
21732,1,0,3,0,-3
21733,0,0,60,0,-60
21734,1,0,26,0,-26
21735,1,0,76,0,-76
21736,0,0,50,0,-50
21737,0,0,26,0,-26
21738,1,0,58,0,-58
21739,1,1,667,1214,547
21740,1,1,10,1306,1296
21741,1,1,79,2098,2019
21742,1,0,1,0,-1
21743,0,0,51,0,-51
21744,0,0,41,0,-41
21745,1,0,13,0,-13
21746,1,0,47,0,-47
21747,1,0,76,0,-76
21748,1,1,587,2181,1594
21749,1,0,76,0,-76
21750,1,0,13,0,-13
21751,1,1,205,1478,1273
21752,0,0,32,0,-32
21753,0,0,10,0,-10
21754,1,1,1954,1254,-700
21755,1,1,91,1387,1296
21756,1,0,28,0,-28
21757,1,1,325,1924,1599
21758,0,0,235,0,-235
21759,1,1,723,1272,549
21760,1,1,24,1413,1389
21761,1,1,652,1567,915
21762,0,0,33,0,-33
21763,1,0,5,0,-5
21764,1,0,107,0,-107
21765,1,0,2,0,-2
21766,0,0,27,0,-27
21767,0,0,15,0,-15
21768,0,0,5,0,-5
21769,1,1,192,1282,1090
21770,0,0,79,0,-79
21771,1,0,19,0,-19
21772,0,0,93,0,-93
21773,1,0,39,0,-39
21774,0,0,127,0,-127
21775,1,1,945,2994,2049
21776,0,0,4,0,-4
21777,0,0,26,0,-26
21778,1,1,67,1840,1773
21779,1,1,421,2143,1722
21780,0,0,93,0,-93
21781,1,1,160,1570,1410
21782,0,0,54,0,-54
21783,0,0,146,0,-146
21784,1,0,131,0,-131
21785,1,1,65,1419,1354
21786,1,1,445,1220,775
21787,1,1,345,1393,1048
21788,1,0,15,0,-15
21789,0,0,18,0,-18
21790,0,0,4,0,-4
21791,1,1,455,1890,1435
21792,1,0,197,0,-197
21793,1,0,29,0,-29
21794,0,0,89,0,-89
21795,1,0,44,0,-44
21796,1,1,121,1286,1165
21797,1,1,64,1221,1157
21798,1,0,75,0,-75
21799,1,1,794,2948,2154
21800,1,1,434,1475,1041
21801,1,1,192,1871,1679
21802,1,1,370,1398,1028
21803,1,1,1175,1269,94
21804,1,0,58,0,-58
21805,1,1,172,1697,1525
21806,1,1,787,1508,721
21807,1,1,64,1422,1358
21808,0,0,15,0,-15
21809,0,0,65,0,-65
21810,1,0,47,0,-47
21811,1,1,207,1605,1398
21812,1,0,15,0,-15
21813,0,0,54,0,-54
21814,0,0,4,0,-4
21815,1,0,2,0,-2
21816,0,0,56,0,-56
21817,0,0,75,0,-75
21818,1,1,355,1485,1130
21819,1,0,74,0,-74
21820,1,1,2831,1202,-1629
21821,1,0,78,0,-78
21822,1,0,236,0,-236
21823,1,1,302,1641,1339
21824,1,0,62,0,-62
21825,1,1,611,1277,666
21826,1,1,596,1456,860
21827,0,0,3,0,-3
21828,0,0,3,0,-3
21829,1,1,352,2151,1799
21830,0,0,31,0,-31
21831,0,0,36,0,-36
21832,0,0,19,0,-19
21833,1,1,879,1607,728
21834,1,1,659,1459,800
21835,1,0,5,0,-5
21836,0,0,58,0,-58
21837,1,1,149,1312,1163
21838,0,0,39,0,-39
21839,0,0,1,0,-1
21840,0,0,16,0,-16
21841,1,0,109,0,-109
21842,1,0,48,0,-48
21843,1,0,42,0,-42
21844,1,0,5,0,-5
21845,0,0,25,0,-25
21846,1,1,242,1318,1076
21847,0,0,77,0,-77
21848,0,0,65,0,-65
21849,0,0,0,0,0
21850,1,1,319,1830,1511
21851,1,0,13,0,-13
21852,1,0,1,0,-1
21853,0,0,4,0,-4
21854,1,1,153,1496,1343
21855,0,0,23,0,-23
21856,1,0,116,0,-116
21857,0,0,19,0,-19
21858,0,0,0,0,0
21859,1,0,135,0,-135
21860,1,1,471,1256,785
21861,1,1,391,1327,936
21862,1,1,31,1796,1765
21863,0,0,3,0,-3
21864,0,0,110,0,-110
21865,1,1,304,1253,949
21866,0,0,13,0,-13
21867,1,0,4,0,-4
21868,0,0,164,0,-164
21869,0,0,33,0,-33
21870,0,0,32,0,-32
21871,1,1,215,1212,997
21872,0,0,92,0,-92
21873,0,0,66,0,-66
21874,0,0,50,0,-50
21875,1,1,289,4401,4112
21876,1,1,631,1269,638
21877,0,0,30,0,-30
21878,1,1,465,1200,735
21879,1,0,18,0,-18
21880,1,0,102,0,-102
21881,0,0,18,0,-18
21882,0,0,36,0,-36
21883,1,0,65,0,-65
21884,1,0,31,0,-31
21885,0,0,26,0,-26
21886,1,1,252,1344,1092
21887,0,0,1,0,-1
21888,1,1,696,1226,530
21889,0,0,43,0,-43
21890,1,0,12,0,-12
21891,1,0,14,0,-14
21892,1,1,1056,1639,583
21893,0,0,106,0,-106
21894,1,1,191,2600,2409
21895,1,1,672,1530,858
21896,0,0,122,0,-122
21897,0,0,90,0,-90
21898,1,1,242,1750,1508
21899,0,0,79,0,-79
21900,0,0,1,0,-1
21901,1,1,251,1219,968
21902,1,1,151,1227,1076
21903,0,0,20,0,-20
21904,0,0,27,0,-27
21905,0,0,31,0,-31
21906,1,0,14,0,-14
21907,1,0,37,0,-37
21908,0,0,87,0,-87
21909,1,0,37,0,-37
21910,0,0,3,0,-3
21911,1,0,206,0,-206
21912,0,0,21,0,-21
21913,0,0,90,0,-90
21914,1,1,721,1202,481
21915,0,0,79,0,-79
21916,1,1,675,1216,541
21917,1,1,506,1616,1110
21918,1,0,16,0,-16
21919,0,0,158,0,-158
21920,0,0,103,0,-103
21921,1,1,441,1201,760
21922,0,0,11,0,-11
21923,1,1,746,1250,504
21924,1,0,82,0,-82
21925,0,0,3,0,-3
21926,1,1,613,1520,907
21927,1,1,210,2651,2441
21928,0,0,24,0,-24
21929,0,0,67,0,-67
21930,1,0,69,0,-69
21931,1,1,365,1750,1385
21932,1,1,132,1620,1488
21933,1,0,15,0,-15
21934,0,0,3,0,-3
21935,0,0,144,0,-144
21936,1,0,15,0,-15
21937,1,1,393,1857,1464
21938,1,0,115,0,-115
21939,1,0,29,0,-29
21940,1,1,571,1340,769
21941,1,0,19,0,-19
21942,1,1,265,1234,969
21943,0,0,5,0,-5
21944,0,0,3,0,-3
21945,1,1,27,1297,1270
21946,0,0,56,0,-56
21947,0,0,42,0,-42
21948,1,1,108,1297,1189
21949,0,0,37,0,-37
21950,1,1,55,1695,1640
21951,1,1,741,1981,1240
21952,1,1,613,1703,1090
21953,1,1,163,2295,2132
21954,1,0,10,0,-10
21955,1,1,585,1561,976
21956,1,0,40,0,-40
21957,1,0,28,0,-28
21958,1,1,1068,1508,440
21959,0,0,3,0,-3
21960,1,0,28,0,-28
21961,1,0,0,0,0
21962,0,0,51,0,-51
21963,1,1,93,1362,1269
21964,1,0,45,0,-45
21965,1,1,532,1970,1438
21966,1,0,6,0,-6
21967,1,0,82,0,-82
21968,0,0,25,0,-25
21969,1,0,43,0,-43
21970,1,1,511,1320,809
21971,1,1,800,1206,406
21972,1,0,86,0,-86
21973,1,0,21,0,-21
21974,1,1,832,1522,690
21975,1,0,138,0,-138
21976,1,0,11,0,-11
21977,0,0,31,0,-31
21978,1,1,193,1461,1268
21979,1,0,19,0,-19
21980,1,0,113,0,-113
21981,1,0,29,0,-29
21982,1,1,162,1210,1048
21983,1,0,12,0,-12
21984,1,1,291,2124,1833
21985,0,0,56,0,-56
21986,0,0,177,0,-177
21987,1,0,0,0,0
21988,1,1,72,2001,1929
21989,1,1,165,1704,1539
21990,1,0,154,0,-154
21991,1,0,45,0,-45
21992,1,1,1264,1254,-10
21993,1,0,3,0,-3
21994,0,0,96,0,-96
21995,1,0,33,0,-33
21996,1,0,32,0,-32
21997,1,0,49,0,-49
21998,1,1,114,1784,1670
21999,0,0,15,0,-15
22000,1,0,2,0,-2
22001,1,1,159,1673,1514
22002,0,0,76,0,-76
22003,0,0,61,0,-61
22004,1,1,385,1440,1055
22005,1,1,642,1601,959
22006,1,1,2039,1381,-658
22007,1,0,18,0,-18
22008,1,0,43,0,-43
22009,1,1,340,1350,1010
22010,1,1,166,1400,1234
22011,0,0,25,0,-25
22012,1,0,57,0,-57
22013,0,0,86,0,-86
22014,1,1,151,1232,1081
22015,0,0,1,0,-1
22016,1,1,44,1346,1302
22017,1,1,835,1244,409
22018,1,0,16,0,-16
22019,0,0,8,0,-8
22020,1,1,100,1373,1273
22021,0,0,15,0,-15
22022,1,1,418,1285,867
22023,1,0,33,0,-33
22024,1,0,43,0,-43
22025,1,0,1,0,-1
22026,1,0,40,0,-40
22027,1,1,22,1231,1209
22028,0,0,0,0,0
22029,1,1,86,1245,1159
22030,0,0,2,0,-2
22031,1,0,12,0,-12
22032,0,0,7,0,-7
22033,1,1,380,1234,854
22034,0,0,57,0,-57
22035,0,0,2,0,-2
22036,1,0,190,0,-190
22037,1,0,30,0,-30
22038,1,1,303,1374,1071
22039,0,0,27,0,-27
22040,1,0,39,0,-39
22041,1,0,101,0,-101
22042,1,0,17,0,-17
22043,1,0,60,0,-60
22044,1,1,75,1217,1142
22045,1,1,808,1771,963
22046,1,0,117,0,-117
22047,0,0,55,0,-55
22048,1,1,2281,1504,-777
22049,0,0,2,0,-2
22050,1,0,39,0,-39
22051,1,0,25,0,-25
22052,1,0,220,0,-220
22053,0,0,98,0,-98
22054,1,0,105,0,-105
22055,0,0,15,0,-15
22056,1,1,434,1235,801
22057,1,0,102,0,-102
22058,1,1,45,1251,1206
22059,1,1,445,1911,1466
22060,0,0,88,0,-88
22061,1,0,83,0,-83
22062,0,0,78,0,-78
22063,1,1,489,1474,985
22064,1,1,205,2071,1866
22065,0,0,0,0,0
22066,1,0,51,0,-51
22067,1,0,14,0,-14
22068,1,1,705,1273,568
22069,0,0,114,0,-114
22070,1,1,444,1902,1458
22071,1,0,32,0,-32
22072,0,0,32,0,-32
22073,0,0,19,0,-19
22074,1,0,6,0,-6
22075,1,0,26,0,-26
22076,0,0,61,0,-61
22077,1,1,1265,1349,84
22078,1,0,2,0,-2
22079,1,1,320,1391,1071
22080,0,0,45,0,-45
22081,1,0,30,0,-30
22082,0,0,5,0,-5
22083,1,1,533,1587,1054
22084,1,0,58,0,-58
22085,1,1,139,1228,1089
22086,1,0,32,0,-32
22087,0,0,139,0,-139
22088,0,0,105,0,-105
22089,1,1,577,1753,1176
22090,1,1,990,1235,245
22091,0,0,97,0,-97
22092,1,1,552,1337,785
22093,0,0,46,0,-46
22094,1,0,3,0,-3
22095,1,0,41,0,-41
22096,1,1,134,1480,1346
22097,1,0,46,0,-46
22098,1,0,3,0,-3
22099,0,0,13,0,-13
22100,1,0,79,0,-79
22101,1,0,21,0,-21
22102,1,0,37,0,-37
22103,1,0,18,0,-18
22104,1,1,26,1916,1890
22105,1,1,74,1286,1212
22106,1,0,51,0,-51
22107,0,0,22,0,-22
22108,0,0,9,0,-9
22109,1,1,310,1336,1026
22110,1,1,280,1335,1055
22111,1,0,11,0,-11
22112,0,0,10,0,-10
22113,0,0,59,0,-59
22114,1,0,35,0,-35
22115,1,0,4,0,-4
22116,1,1,450,1588,1138
22117,1,0,23,0,-23
22118,1,0,89,0,-89
22119,0,0,28,0,-28
22120,1,1,438,1316,878
22121,0,0,59,0,-59
22122,0,0,98,0,-98
22123,1,1,135,1750,1615
22124,1,0,70,0,-70
22125,1,0,5,0,-5
22126,1,1,1508,1349,-159
22127,1,1,553,1313,760
22128,1,1,2210,1200,-1010
22129,1,1,692,1278,586
22130,0,0,4,0,-4
22131,1,1,839,1630,791
22132,1,1,308,2165,1857
22133,1,1,119,1321,1202
22134,1,1,945,1470,525
22135,1,1,332,1578,1246
22136,0,0,16,0,-16
22137,1,1,376,1971,1595
22138,1,1,194,1691,1497
22139,1,0,15,0,-15
22140,1,1,1234,1424,190
22141,1,0,100,0,-100
22142,1,0,20,0,-20
22143,1,1,369,1410,1041
22144,1,0,41,0,-41
22145,1,1,439,1859,1420
22146,1,1,956,1259,303
22147,1,1,1341,1592,251
22148,1,1,297,1433,1136
22149,1,0,83,0,-83
22150,0,0,34,0,-34
22151,1,0,112,0,-112
22152,1,1,512,1388,876
22153,1,0,11,0,-11
22154,1,1,125,1604,1479
22155,0,0,90,0,-90
22156,0,0,31,0,-31
22157,0,0,165,0,-165
22158,1,1,42,1747,1705
22159,0,0,17,0,-17
22160,1,1,567,1449,882
22161,0,0,26,0,-26
22162,1,0,55,0,-55
22163,0,0,37,0,-37
22164,0,0,2,0,-2
22165,0,0,10,0,-10
22166,1,1,378,1786,1408
22167,1,1,1883,1348,-535
22168,1,0,27,0,-27
22169,1,1,106,1319,1213
22170,1,1,103,1575,1472
22171,1,0,89,0,-89
22172,1,1,324,1345,1021
22173,0,0,3,0,-3
22174,1,0,19,0,-19
22175,1,0,1,0,-1
22176,1,1,725,1270,545
22177,0,0,9,0,-9
22178,1,1,39,1291,1252
22179,1,1,510,1254,744
22180,0,0,21,0,-21
22181,1,1,182,1407,1225
22182,0,0,146,0,-146
22183,0,0,49,0,-49
22184,1,1,240,1206,966
22185,0,0,18,0,-18
22186,1,1,1316,2358,1042
22187,1,1,452,1750,1298
22188,0,0,19,0,-19
22189,1,1,758,1394,636
22190,1,1,247,1667,1420
22191,0,0,33,0,-33
22192,1,0,30,0,-30
22193,1,1,230,1208,978
22194,1,0,81,0,-81
22195,1,0,5,0,-5
22196,0,0,43,0,-43
22197,1,1,497,1507,1010
22198,1,0,17,0,-17
22199,1,1,880,1966,1086
22200,1,1,97,1483,1386
22201,1,0,25,0,-25
22202,1,1,1346,1298,-48
22203,1,0,16,0,-16
22204,0,0,12,0,-12
22205,1,1,547,1470,923
22206,0,0,91,0,-91
22207,0,0,29,0,-29
22208,1,0,55,0,-55
22209,1,0,2,0,-2
22210,0,0,26,0,-26
22211,1,1,88,1561,1473
22212,0,0,4,0,-4
22213,1,0,59,0,-59
22214,0,0,10,0,-10
22215,0,0,47,0,-47
22216,0,0,95,0,-95
22217,1,0,54,0,-54
22218,0,0,18,0,-18
22219,1,1,97,1262,1165
22220,1,1,217,1298,1081
22221,1,0,23,0,-23
22222,1,0,79,0,-79
22223,1,0,63,0,-63
22224,0,0,20,0,-20
22225,0,0,121,0,-121
22226,0,0,81,0,-81
22227,1,1,371,1253,882
22228,0,0,65,0,-65
22229,0,0,120,0,-120
22230,0,0,2,0,-2
22231,1,1,172,2275,2103
22232,0,0,21,0,-21
22233,0,0,64,0,-64
22234,1,1,636,1229,593
22235,1,0,187,0,-187
22236,1,1,209,1340,1131
22237,1,0,4,0,-4
22238,0,0,74,0,-74
22239,0,0,1,0,-1
22240,0,0,81,0,-81
22241,1,0,79,0,-79
22242,0,0,127,0,-127
22243,1,0,3,0,-3
22244,1,1,189,1422,1233
22245,1,1,1566,1225,-341
22246,1,0,29,0,-29
22247,1,1,227,1260,1033
22248,0,0,12,0,-12
22249,1,1,893,1808,915
22250,1,1,93,1340,1247
22251,1,0,19,0,-19
22252,0,0,108,0,-108
22253,1,0,5,0,-5
22254,0,0,32,0,-32
22255,0,0,4,0,-4
22256,1,0,47,0,-47
22257,0,0,29,0,-29
22258,0,0,84,0,-84
22259,1,0,23,0,-23
22260,0,0,17,0,-17
22261,0,0,9,0,-9
22262,1,1,103,1836,1733
22263,0,0,30,0,-30
22264,0,0,81,0,-81
22265,1,1,447,1373,926
22266,0,0,117,0,-117
22267,0,0,37,0,-37
22268,0,0,68,0,-68
22269,0,0,11,0,-11
22270,0,0,0,0,0
22271,0,0,72,0,-72
22272,1,0,7,0,-7
22273,0,0,69,0,-69
22274,0,0,55,0,-55
22275,1,0,104,0,-104
22276,0,0,16,0,-16
22277,1,1,243,1272,1029
22278,1,0,144,0,-144
22279,1,1,782,1697,915
22280,0,0,91,0,-91
22281,1,1,1092,1315,223
22282,1,1,641,1447,806
22283,0,0,57,0,-57
22284,1,0,98,0,-98
22285,1,0,10,0,-10
22286,1,0,43,0,-43
22287,1,1,618,1322,704
22288,1,1,264,1575,1311
22289,1,0,73,0,-73
22290,0,0,0,0,0
22291,0,0,30,0,-30
22292,1,1,314,1263,949
22293,0,0,47,0,-47
22294,0,0,9,0,-9
22295,0,0,1,0,-1
22296,0,0,47,0,-47
22297,1,0,107,0,-107
22298,1,1,173,1220,1047
22299,0,0,3,0,-3
22300,1,0,130,0,-130
22301,0,0,23,0,-23
22302,1,0,46,0,-46
22303,0,0,175,0,-175
22304,1,1,140,1344,1204
22305,1,0,62,0,-62
22306,1,1,327,1261,934
22307,0,0,75,0,-75
22308,1,1,264,1614,1350
22309,0,0,37,0,-37
22310,0,0,10,0,-10
22311,0,0,134,0,-134
22312,0,0,132,0,-132
22313,1,1,479,1455,976
22314,0,0,214,0,-214
22315,0,0,1,0,-1
22316,1,1,356,1239,883
22317,1,1,37,1573,1536
22318,1,0,19,0,-19
22319,1,1,383,1257,874
22320,0,0,9,0,-9
22321,1,1,166,1231,1065
22322,0,0,105,0,-105
22323,0,0,61,0,-61
22324,1,1,677,3594,2917
22325,1,1,279,1596,1317
22326,1,0,46,0,-46
22327,1,1,50,1363,1313
22328,1,0,70,0,-70
22329,0,0,21,0,-21
22330,1,1,311,1571,1260
22331,0,0,58,0,-58
22332,1,0,7,0,-7
22333,1,1,1020,1681,661
22334,1,0,7,0,-7
22335,0,0,8,0,-8
22336,0,0,62,0,-62
22337,1,0,3,0,-3
22338,1,0,16,0,-16
22339,0,0,10,0,-10
22340,1,0,7,0,-7
22341,1,1,1206,1583,377
22342,0,0,46,0,-46
22343,0,0,179,0,-179
22344,1,0,38,0,-38
22345,0,0,18,0,-18
22346,1,0,81,0,-81
22347,1,0,58,0,-58
22348,1,1,1552,1779,227
22349,1,0,42,0,-42
22350,1,1,213,1515,1302
22351,0,0,18,0,-18
22352,1,1,91,1510,1419
22353,0,0,33,0,-33
22354,0,0,62,0,-62
22355,0,0,5,0,-5
22356,1,0,5,0,-5
22357,1,0,154,0,-154
22358,0,0,232,0,-232
22359,1,1,222,1892,1670
22360,1,0,113,0,-113
22361,0,0,1,0,-1
22362,1,0,0,0,0
22363,1,1,272,1436,1164
22364,0,0,51,0,-51
22365,1,1,191,1865,1674
22366,1,0,38,0,-38
22367,1,0,63,0,-63
22368,1,1,248,1263,1015
22369,1,1,628,1288,660
22370,0,0,14,0,-14
22371,1,1,638,2396,1758
22372,1,0,43,0,-43
22373,0,0,13,0,-13
22374,1,0,24,0,-24
22375,0,0,177,0,-177
22376,1,0,33,0,-33
22377,1,1,937,5293,4356
22378,0,0,172,0,-172
22379,1,1,428,1834,1406
22380,1,1,614,2307,1693
22381,0,0,82,0,-82
22382,0,0,47,0,-47
22383,1,0,13,0,-13
22384,1,1,740,1624,884
22385,1,0,8,0,-8
22386,1,0,50,0,-50
22387,0,0,177,0,-177
22388,1,0,27,0,-27
22389,1,0,98,0,-98
22390,1,0,0,0,0
22391,1,0,9,0,-9
22392,0,0,27,0,-27
22393,0,0,45,0,-45
22394,1,0,25,0,-25
22395,1,0,15,0,-15
22396,1,0,91,0,-91
22397,0,0,23,0,-23
22398,1,1,435,2486,2051
22399,0,0,18,0,-18
22400,1,1,269,1351,1082
22401,0,0,140,0,-140
22402,1,1,732,1499,767
22403,1,0,156,0,-156
22404,0,0,128,0,-128
22405,0,0,3,0,-3
22406,0,0,128,0,-128
22407,1,0,56,0,-56
22408,0,0,7,0,-7
22409,1,1,672,1693,1021
22410,0,0,13,0,-13
22411,0,0,50,0,-50
22412,1,0,47,0,-47
22413,0,0,51,0,-51
22414,0,0,21,0,-21
22415,0,0,231,0,-231
22416,1,0,97,0,-97
22417,1,0,152,0,-152
22418,0,0,5,0,-5
22419,1,1,2134,1541,-593
22420,1,0,2,0,-2
22421,1,1,223,2060,1837
22422,1,1,358,1215,857
22423,0,0,16,0,-16
22424,1,1,584,6400,5816
22425,1,0,54,0,-54
22426,1,1,591,1455,864
22427,1,0,2,0,-2
22428,1,1,481,1262,781
22429,1,1,97,1745,1648
22430,1,1,535,1389,854
22431,1,0,148,0,-148
22432,0,0,24,0,-24
22433,1,0,14,0,-14
22434,1,1,566,1334,768
22435,0,0,62,0,-62
22436,0,0,37,0,-37
22437,1,0,27,0,-27
22438,1,0,28,0,-28
22439,1,1,208,1425,1217
22440,1,0,101,0,-101
22441,1,1,1349,2161,812
22442,1,1,240,1366,1126
22443,1,1,29,1502,1473
22444,1,0,107,0,-107
22445,0,0,51,0,-51
22446,1,1,677,3809,3132
22447,0,0,18,0,-18
22448,0,0,12,0,-12
22449,0,0,1,0,-1
22450,1,0,18,0,-18
22451,1,1,896,1362,466
22452,0,0,77,0,-77
22453,1,0,53,0,-53
22454,1,0,120,0,-120
22455,0,0,8,0,-8
22456,0,0,14,0,-14
22457,1,1,1200,1985,785
22458,1,0,85,0,-85
22459,1,0,48,0,-48
22460,1,1,649,1342,693
22461,1,0,74,0,-74
22462,1,1,389,1233,844
22463,1,1,129,1491,1362
22464,1,1,427,1232,805
22465,0,0,3,0,-3
22466,1,0,127,0,-127
22467,0,0,22,0,-22
22468,1,0,81,0,-81
22469,1,0,8,0,-8
22470,0,0,27,0,-27
22471,0,0,71,0,-71
22472,1,0,32,0,-32
22473,1,1,1117,1775,658
22474,0,0,20,0,-20
22475,0,0,18,0,-18
22476,0,0,1,0,-1
22477,0,0,15,0,-15
22478,1,1,489,2389,1900
22479,0,0,92,0,-92
22480,0,0,7,0,-7
22481,0,0,51,0,-51
22482,1,1,64,2197,2133
22483,0,0,62,0,-62
22484,0,0,41,0,-41
22485,1,0,10,0,-10
22486,1,0,63,0,-63
22487,1,0,11,0,-11
22488,0,0,102,0,-102
22489,0,0,37,0,-37
22490,0,0,119,0,-119
22491,0,0,24,0,-24
22492,1,0,24,0,-24
22493,0,0,4,0,-4
22494,0,0,3,0,-3
22495,1,1,3681,1281,-2400
22496,0,0,20,0,-20
22497,1,0,102,0,-102
22498,1,0,15,0,-15
22499,1,1,352,1459,1107
22500,1,0,63,0,-63
22501,0,0,14,0,-14
22502,1,1,66,1274,1208
22503,1,0,17,0,-17
22504,0,0,71,0,-71
22505,0,0,124,0,-124
22506,0,0,92,0,-92
22507,0,0,62,0,-62
22508,0,0,114,0,-114
22509,1,1,633,2016,1383
22510,1,1,1230,1284,54
22511,0,0,121,0,-121
22512,0,0,23,0,-23
22513,1,0,37,0,-37
22514,0,0,1,0,-1
22515,1,0,282,0,-282
22516,1,1,1890,1679,-211
22517,1,0,39,0,-39
22518,1,1,109,1234,1125
22519,0,0,31,0,-31
22520,0,0,40,0,-40
22521,0,0,72,0,-72
22522,1,0,65,0,-65
22523,0,0,59,0,-59
22524,0,0,146,0,-146
22525,1,1,240,1264,1024
22526,1,0,0,0,0
22527,1,0,207,0,-207
22528,0,0,7,0,-7
22529,1,1,30,2179,2149
22530,0,0,163,0,-163
